</s>	</s>
.	.
,	,
)	)
(	(
'	'
-	-
#	#
}	}
/	/
~	~
·	·
\	\
%	%
?	?
the	the
a	a
m	m
of	of
!	!
"	"
→	→
s	s
b	b
‘	‘
+	+
f	f
tv	tv
d	d
–	–
jpg	jpg
mbc	mbc
x	x
c	c
and	and
km	km
e	e
in	in
sbs	sbs
k	k
t	t
&	&
r	r
n	n
align	align
fc	fc
^	^
h	h
style	style
u	u
http	http
www	www
svg	svg
rd	rd
_	_
to	to
i	i
p	p
g	g
com	com
isbn	isbn
fifa	fifa
cm	cm
px	px
v	v
border	border
left	left
j	j
l	l
center	center
kr	kr
score	score
mm	mm
for	for
text	text
w	w
https	https
on	on
ec	ec
de	de
>	>
team	team
uefa	uefa
ii	ii
↔	↔
y	y
o	o
by	by
×	×
at	at
fm	fm
color	color
is	is
org	org
kg	kg
z	z
lg	lg
solid	solid
with	with
png	png
from	from
width	width
background	background
cd	cd
q	q
sk	sk
aaa	aaa
you	you
flag	flag
right	right
—	—
ip	ip
no	no
•	•
love	love
new	new
it	it
bgcolor	bgcolor
top	top
or	or
eb	eb
utc	utc
■	■
world	world
la	la
group	group
jr	jr
if	if
goals	goals
as	as
th	th
black	black
my	my
hd	hd
rowspan	rowspan
vs	vs
co	co
dvd	dvd
…	…
university	university
one	one
ed	ed
●	●
colspan	colspan
stadium	stadium
ac	ac
pc	pc
go	go
me	me
ook	ook
afc	afc
ffffff	ffffff
wikipedia	wikipedia
em	em
ko	ko
ff	ff
es	es
mc	mc
an	an
music	music
be	be
°	°
²	²
$	$
file	file
fa	fa
this	this
nhk	nhk
rev	rev
korea	korea
us	us
bc	bc
link	link
not	not
tbs	tbs
index	index
kt	kt
iso	iso
all	all
title	title
lee	lee
ss	ss
ms	ms
part	part
`	`
dj	dj
live	live
report	report
john	john
local	local
data	data
time	time
white	white
up	up
mvp	mvp
st	st
best	best
national	national
single	single
ea	ea
that	that
ost	ost
first	first
seed	seed
image	image
international	international
net	net
then	then
os	os
station	station
vol	vol
php	php
html	html
_p	_p
@	@
pop	pop
press	press
ep	ep
al	al
history	history
digital	digital
are	are
min	min
news	news
do	do
le	le
bbc	bbc
school	school
day	day
pictogram	pictogram
†	†
sf	sf
men	men
body	body
type	type
mhz	mhz
dna	dna
pd	pd
et	et
talk	talk
life	life
wiki	wiki
iii	iii
valign	valign
map	map
colon	colon
id	id
times	times
cf	cf
cj	cj
ft	ft
list	list
japan	japan
sc	sc
feat	feat
en	en
nt	nt
cc	cc
ver	ver
system	system
version	version
yes	yes
±	±
we	we
war	war
club	club
pattern_b	pattern_b
line	line
nc	nc
class	class
result	result
am	am
park	park
wwe	wwe
your	your
cpu	cpu
socks	socks
un	un
video	video
man	man
bs	bs
sm	sm
alpha	alpha
ø	ø
bar	bar
user	user
ch	ch
shorts	shorts
round	round
city	city
can	can
project	project
page	page
return	return
star	star
pattern_la	pattern_la
name	name
official	official
pattern_ra	pattern_ra
space	space
david	david
jtm	jtm
ps	ps
ad	ad
label	label
htm	htm
american	american
end	end
♪	♪
red	red
york	york
alt	alt
place	place
blue	blue
may	may
tour	tour
final	final
ab	ab
ta	ta
function	function
so	so
website	website
leftarm	leftarm
ceo	ceo
ds	ds
font	font
dc	dc
twitter	twitter
good	good
normal	normal
cbs	cbs
arm	arm
set	set
air	air
facebook	facebook
msl	msl
nba	nba
mp	mp
youtube	youtube
pp	pp
der	der
mr	mr
was	was
code	code
rock	rock
ic	ic
size	size
high	high
season	season
united	united
web	web
women	women
args	args
year	year
default	default
state	state
song	song
phi	phi
language	language
night	night
will	will
​	​
radio	radio
james	james
off	off
gb	gb
about	about
two	two
eu	eu
hs	hs
album	album
usa	usa
nd	nd
girl	girl
information	information
ca	ca
don	don
football	football
out	out
op	op
london	london
‎	‎
el	el
uk	uk
home	home
show	show
special	special
ibm	ibm
robert	robert
english	english
con	con
stat	stat
ex	ex
william	william
abc	abc
site	site
south	south
road	road
who	who
last	last
only	only
mlb	mlb
soul	soul
back	back
airport	airport
des	des
mb	mb
padding	padding
korean	korean
aa	aa
mnet	mnet
story	story
science	science
article	article
over	over
value	value
instrumental	instrumental
heart	heart
michael	michael
mtv	mtv
dr	dr
free	free
jp	jp
re	re
more	more
cet	cet
edition	edition
sa	sa
dream	dream
medal	medal
hun	hun
what	what
king	king
se	se
kb	kb
summer	summer
productions	productions
sd	sd
x_	x_
main	main
ngc	ngc
uss	uss
sp	sp
←	←
url	url
college	college
george	george
iv	iv
open	open
art	art
du	du
delta	delta
sky	sky
great	great
date	date
seoul	seoul
paul	paul
da	da
die	die
true	true
big	big
arms	arms
way	way
book	book
table	table
von	von
game	game
journal	journal
society	society
movie	movie
now	now
mk	mk
power	power
−	−
pi	pi
profile	profile
entertainment	entertainment
usb	usb
mu	mu
long	long
int	int
party	party
mix	mix
super	super
like	like
gold	gold
house	house
company	company
pt	pt
xp	xp
wii	wii
pdf	pdf
research	research
au	au
dance	dance
kw	kw
island	island
records	records
beta	beta
other	other
gnu	gnu
kim	kim
wikimedia	wikimedia
ova	ova
san	san
sv	sv
fk	fk
instagram	instagram
non	non
original	original
have	have
god	god
db	db
he	he
people	people
di	di
und	und
diff	diff
mark	mark
green	green
a_	a_
max	max
charles	charles
days	days
states	states
institute	institute
dx	dx
mi	mi
cs	cs
boy	boy
battle	battle
del	del
pm	pm
thomas	thomas
nasa	nasa
online	online
mw	mw
cup	cup
inc	inc
north	north
xx	xx
oldid	oldid
vocal	vocal
gs	gs
award	award
omega	omega
his	his
gamma	gamma
cp	cp
bullet	bullet
si	si
view	view
general	general
su	su
republic	republic
ne	ne
museum	museum
light	light
gfdl	gfdl
baby	baby
field	field
coat	coat
west	west
number	number
sports	sports
which	which
global	global
public	public
ph	ph
get	get
oh	oh
china	china
peter	peter
edit	edit
second	second
tokyo	tokyo
remix	remix
how	how
stage	stage
pages	pages
till	till
mg	mg
richard	richard
yg	yg
sigma	sigma
collection	collection
library	library
frame	frame
league	league
service	service
series	series
happy	happy
association	association
east	east
api	api
gt	gt
let	let
use	use
google	google
location	location
young	young
svn	svn
ob	ob
after	after
led	led
side	side
er	er
archive	archive
heat	heat
law	law
three	three
les	les
human	human
film	film
windows	windows
force	force
alto	alto
little	little
hall	hall
sin	sin
rna	rna
our	our
old	old
county	county
but	but
ios	ios
ghz	ghz
bottom	bottom
vertical	vertical
match	match
did	did
hello	hello
concacaf	concacaf
when	when
lcd	lcd
there	there
hot	hot
ha	ha
box	box
ll	ll
van	van
sound	sound
ils	ils
khz	khz
ag	ag
america	america
media	media
unit	unit
action	action
watch	watch
has	has
af	af
upright	upright
height	height
see	see
lost	lost
network	network
lambda	lambda
var	var
used	used
sun	sun
program	program
land	land
saint	saint
template	template
studio	studio
dd	dd
sea	sea
none	none
ieee	ieee
amd	amd
japanese	japanese
festival	festival
guide	guide
technology	technology
na	na
jean	jean
france	france
books	books
oc	oc
asia	asia
dots	dots
moon	moon
il	il
nm	nm
winter	winter
css	css
track	track
royal	royal
standard	standard
α	α
knight	knight
girls	girls
dp	dp
revision	revision
ge	ge
male	male
log	log
work	work
brown	brown
just	just
ltd	ltd
also	also
nowrap	nowrap
into	into
c_	c_
nbc	nbc
down	down
films	films
joseph	joseph
psi	psi
kiss	kiss
self	self
jan	jan
middle	middle
drama	drama
theory	theory
century	century
lp	lp
smith	smith
gm	gm
order	order
bb	bb
martin	martin
ray	ray
again	again
ntv	ntv
platform	platform
front	front
caps	caps
ba	ba
pictures	pictures
here	here
pattern_sh	pattern_sh
ratio	ratio
boys	boys
real	real
act	act
cambridge	cambridge
family	family
hat	hat
fire	fire
gdp	gdp
union	union
army	army
every	every
ma	ma
articles	articles
river	river
source	source
key	key
grand	grand
bad	bad
ef	ef
never	never
gif	gif
lb	lb
string	string
games	games
cia	cia
review	review
tc	tc
hp	hp
dos	dos
management	management
march	march
come	come
street	street
»	»
irc	irc
full	full
its	its
species	species
control	control
german	german
paris	paris
oxford	oxford
hms	hms
database	database
their	their
head	head
gov	gov
next	next
christian	christian
cos	cos
make	make
where	where
under	under
sl	sl
july	july
bus	bus
pro	pro
church	church
nato	nato
bmw	bmw
add	add
mit	mit
design	design
works	works
scott	scott
silver	silver
roland	roland
ak	ak
row	row
foo	foo
pattern_so	pattern_so
say	say
cross	cross
british	british
bd	bd
iata	iata
office	office
awards	awards
take	take
im	im
rx	rx
ram	ram
master	master
license	license
md	md
apg	apg
volume	volume
fr	fr
henry	henry
search	search
encyclopedia	encyclopedia
imf	imf
double	double
model	model
age	age
some	some
logo	logo
chris	chris
shift	shift
business	business
sweet	sweet
veritas	veritas
cat	cat
water	water
jack	jack
av	av
earth	earth
band	band
replace	replace
development	development
ja	ja
they	they
concert	concert
point	point
death	death
rgb	rgb
ax	ax
modern	modern
hill	hill
recent	recent
train	train
without	without
play	play
louis	louis
miss	miss
sign	sign
ap	ap
sg	sg
peace	peace
xml	xml
run	run
jump	jump
education	education
format	format
reference	reference
germany	germany
dark	dark
plus	plus
olympic	olympic
change	change
sr	sr
dec	dec
castle	castle
foundation	foundation
cv	cv
tu	tu
than	than
august	august
retrieved	retrieved
four	four
hr	hr
years	years
april	april
were	were
case	case
pr	pr
bridge	bridge
central	central
psp	psp
editor	editor
stars	stars
country	country
mx	mx
cn	cn
asp	asp
another	another
nh	nh
lte	lte
sub	sub
future	future
iucn	iucn
internet	internet
christmas	christmas
mar	mar
edward	edward
tr	tr
artist	artist
small	small
california	california
ro	ro
snow	snow
rom	rom
town	town
form	form
mind	mind
division	division
mail	mail
hikaru	hikaru
dictionary	dictionary
f_	f_
most	most
june	june
biography	biography
begin	begin
studies	studies
advance	advance
software	software
queen	queen
allen	allen
nil	nil
month	month
gps	gps
cr	cr
fx	fx
rightarm	rightarm
ffff	ffff
points	points
content	content
french	french
cell	cell
jun	jun
dead	dead
ever	ever
test	test
event	event
hey	hey
zone	zone
magazine	magazine
social	social
culture	culture
note	note
v_	v_
false	false
dragon	dragon
jones	jones
any	any
ce	ce
€	€
arts	arts
centre	centre
gray	gray
los	los
mt	mt
kingdom	kingdom
ae	ae
per	per
five	five
atp	atp
tree	tree
mpeg	mpeg
ai	ai
jm	jm
common	common
chapter	chapter
low	low
european	european
daniel	daniel
zero	zero
channel	channel
mac	mac
seven	seven
β	β
corporation	corporation
hi	hi
know	know
swimming	swimming
area	area
maria	maria
systems	systems
made	made
athletics	athletics
military	military
songs	songs
september	september
gp	gp
engineering	engineering
short	short
disc	disc
sql	sql
stop	stop
m_	m_
rain	rain
lady	lady
analysis	analysis
pl	pl
council	council
ie	ie
beautiful	beautiful
islands	islands
major	major
nhl	nhl
legend	legend
rfc	rfc
before	before
record	record
cg	cg
level	level
rc	rc
li	li
beat	beat
nov	nov
edu	edu
ka	ka
bk	bk
between	between
revolution	revolution
vi	vi
teams	teams
ah	ah
fi	fi
p_	p_
section	section
dt	dt
msg	msg
xi	xi
santa	santa
bart	bart
nu	nu
computer	computer
speed	speed
tom	tom
kn	kn
mf	mf
angel	angel
ui	ui
mod	mod
voice	voice
plants	plants
face	face
exp	exp
boeing	boeing
individual	individual
building	building
mary	mary
call	call
through	through
r_	r_
t_	t_
rs	rs
uc	uc
error	error
based	based
blood	blood
europe	europe
fe	fe
canada	canada
photo	photo
early	early
her	her
prince	prince
tna	tna
mode	mode
wake	wake
aug	aug
magic	magic
signature	signature
g_	g_
memory	memory
fbi	fbi
andrew	andrew
apple	apple
itv	itv
start	start
rpg	rpg
forever	forever
using	using
secret	secret
province	province
message	message
scope	scope
ice	ice
ml	ml
fox	fox
gpu	gpu
jpeg	jpeg
diary	diary
nature	nature
simon	simon
empire	empire
info	info
machine	machine
df	df
competition	competition
images	images
bank	bank
deep	deep
step	step
evolution	evolution
why	why
logos	logos
parameter	parameter
naval	naval
java	java
oct	oct
department	department
nk	nk
academy	academy
natural	natural
sam	sam
spring	spring
kappa	kappa
fly	fly
coa	coa
nation	nation
microsoft	microsoft
november	november
security	security
mig	mig
won	won
australia	australia
eyes	eyes
via	via
♥	♥
ar	ar
weight	weight
range	range
berlin	berlin
golden	golden
post	post
emi	emi
bit	bit
third	third
russian	russian
ee	ee
episode	episode
pv	pv
bgm	bgm
gun	gun
tilde	tilde
hz	hz
ref	ref
kc	kc
acid	acid
historical	historical
wolf	wolf
civil	civil
rr	rr
cap	cap
tower	tower
chinese	chinese
sep	sep
being	being
ok	ok
been	been
away	away
classic	classic
est	est
break	break
board	board
still	still
names	names
western	western
pa	pa
community	community
publishing	publishing
ats	ats
latest	latest
region	region
sleep	sleep
base	base
mobile	mobile
frank	frank
wave	wave
hip	hip
born	born
vfb	vfb
tg	tg
np	np
chi	chi
these	these
sh	sh
bot	bot
wild	wild
please	please
october	october
brian	brian
module	module
rose	rose
africa	africa
hour	hour
arthur	arthur
pacific	pacific
block	block
money	money
heaven	heaven
she	she
den	den
complete	complete
alexander	alexander
ship	ship
js	js
available	available
dave	dave
anniversary	anniversary
conference	conference
generation	generation
government	government
col	col
cl	cl
want	want
b_	b_
district	district
washington	washington
bye	bye
pg	pg
ln	ln
plant	plant
hk	hk
square	square
tag	tag
study	study
mass	mass
sir	sir
win	win
each	each
championship	championship
sciences	sciences
ddr	ddr
blog	blog
ann	ann
broad	broad
cool	cool
cb	cb
ks	ks
december	december
events	events
emblem	emblem
introduction	introduction
fall	fall
player	player
stone	stone
ssr	ssr
br	br
mini	mini
feb	feb
bob	bob
january	january
mba	mba
core	core
programming	programming
ls	ls
jul	jul
had	had
hard	hard
ru	ru
joe	joe
ia	ia
stephen	stephen
wilson	wilson
help	help
jam	jam
alex	alex
give	give
ns	ns
oecd	oecd
lake	lake
president	president
marie	marie
auto	auto
energy	energy
operation	operation
apr	apr
flower	flower
india	india
eos	eos
elseif	elseif
morning	morning
arena	arena
adam	adam
te	te
francis	francis
que	que
williams	williams
advanced	advanced
johnson	johnson
users	users
check	check
against	against
steve	steve
″	″
must	must
isu	isu
bill	bill
lang	lang
ve	ve
notes	notes
inside	inside
das	das
many	many
should	should
ga	ga
ymca	ymca
summary	summary
february	february
ts	ts
spain	spain
sta	sta
partial	partial
ix	ix
mountain	mountain
very	very
roman	roman
brothers	brothers
iec	iec
need	need
flight	flight
plain	plain
process	process
planet	planet
prize	prize
woman	woman
cnn	cnn
ufc	ufc
got	got
beach	beach
example	example
dear	dear
freedom	freedom
oo	oo
e_	e_
asian	asian
look	look
wall	wall
files	files
nations	nations
xxx	xxx
ring	ring
sim	sim
movement	movement
header	header
bronze	bronze
clip	clip
room	room
featuring	featuring
tournament	tournament
nl	nl
making	making
rt	rt
fiba	fiba
chicago	chicago
uhf	uhf
during	during
northern	northern
find	find
status	status
pink	pink
xbox	xbox
eric	eric
railway	railway
limited	limited
hong	hong
blu	blu
gpl	gpl
bf	bf
opera	opera
crazy	crazy
bsd	bsd
race	race
display	display
tau	tau
galaxy	galaxy
russia	russia
taylor	taylor
interview	interview
kv	kv
bj	bj
feel	feel
jyp	jyp
piece	piece
gn	gn
garden	garden
today	today
ufo	ufo
same	same
children	children
together	together
document	document
h_	h_
raw	raw
albert	albert
release	release
piano	piano
committee	committee
ci	ci
∞	∞
rainbow	rainbow
sms	sms
visual	visual
ace	ace
models	models
ni	ni
metropolitan	metropolitan
dot	dot
alan	alan
son	son
enigma	enigma
sn	sn
y_	y_
anthony	anthony
metro	metro
prime	prime
kids	kids
orchestra	orchestra
mission	mission
health	health
bsc	bsc
near	near
bell	bell
xy	xy
links	links
a_n	a_n
carl	carl
total	total
à	à
performance	performance
access	access
x_n	x_n
count	count
hero	hero
translation	translation
support	support
nine	nine
express	express
bird	bird
ensign	ensign
gui	gui
für	für
else	else
mls	mls
circle	circle
production	production
sony	sony
smile	smile
fields	fields
stand	stand
entry	entry
believe	believe
freestyle	freestyle
lc	lc
bay	bay
usda	usda
current	current
jane	jane
christopher	christopher
blason	blason
universal	universal
sw	sw
sport	sport
mike	mike
doc	doc
dan	dan
walter	walter
attack	attack
lewis	lewis
effect	effect
pov	pov
published	published
pci	pci
length	length
following	following
gallery	gallery
linux	linux
fps	fps
ahl	ahl
photos	photos
present	present
marine	marine
rights	rights
lord	lord
lv	lv
cu	cu
harry	harry
southern	southern
ho	ho
economic	economic
both	both
jesus	jesus
½	½
genre	genre
political	political
icao	icao
female	female
well	well
results	results
alive	alive
sur	sur
ball	ball
tnt	tnt
england	england
kd	kd
policy	policy
ya	ya
category	category
letter	letter
animation	animation
them	them
federation	federation
navy	navy
aircraft	aircraft
mer	mer
karl	karl
baseball	baseball
shot	shot
would	would
void	void
airlines	airlines
aim	aim
philosophy	philosophy
x_i	x_i
around	around
trans	trans
hl	hl
basic	basic
regards	regards
friends	friends
touch	touch
object	object
carlos	carlos
fb	fb
csi	csi
oz	oz
po	po
hans	hans
hotel	hotel
temple	temple
gate	gate
med	med
plan	plan
nuclear	nuclear
audio	audio
while	while
ev	ev
rpm	rpm
author	author
edge	edge
holy	holy
read	read
method	method
exile	exile
jackson	jackson
character	character
{	{
complex	complex
australian	australian
espn	espn
yellow	yellow
mv	mv
fs	fs
eye	eye
such	such
olympics	olympics
nx	nx
ngo	ngo
anna	anna
server	server
mid	mid
is_set	is_set
picture	picture
food	food
tennis	tennis
italy	italy
joy	joy
ltr	ltr
insert	insert
cw	cw
pierre	pierre
wind	wind
ng	ng
found	found
dsp	dsp
commons	commons
electric	electric
elizabeth	elizabeth
vii	vii
n_	n_
large	large
bold	bold
ben	ben
memorial	memorial
drive	drive
guitar	guitar
exe	exe
jason	jason
fn	fn
fff	fff
director	director
kong	kong
atm	atm
sexy	sexy
fair	fair
medical	medical
bang	bang
welcome	welcome
valley	valley
because	because
jk	jk
ct	ct
technical	technical
htc	htc
issue	issue
virtual	virtual
leo	leo
market	market
command	command
preview	preview
catholic	catholic
defense	defense
domain	domain
easy	easy
div	div
thank	thank
flow	flow
josé	josé
dog	dog
flash	flash
bl	bl
mbps	mbps
friend	friend
perfect	perfect
simple	simple
nfl	nfl
z_	z_
tft	tft
professor	professor
choice	choice
publisher	publisher
including	including
paper	paper
publications	publications
motion	motion
francisco	francisco
target	target
forward	forward
ground	ground
port	port
too	too
gordon	gordon
endless	endless
cdma	cdma
steven	steven
tcp	tcp
wonder	wonder
car	car
protocol	protocol
soviet	soviet
tell	tell
services	services
hand	hand
texas	texas
lower	lower
kei	kei
below	below
fiav	fiav
jsp	jsp
wp	wp
stay	stay
pre	pre
subway	subway
six	six
rio	rio
organization	organization
jay	jay
ir	ir
mediawiki	mediawiki
davis	davis
physics	physics
architecture	architecture
operating	operating
meta	meta
td	td
δ	δ
ipv	ipv
word	word
problem	problem
portal	portal
far	far
klm	klm
wi	wi
ib	ib
above	above
dreams	dreams
truth	truth
princess	princess
gk	gk
tan	tan
anne	anne
mexico	mexico
mother	mother
learning	learning
juan	juan
wcw	wcw
child	child
smart	smart
different	different
ten	ten
sos	sos
greatest	greatest
alice	alice
eastern	eastern
butterfly	butterfly
shooting	shooting
mah	mah
languages	languages
shin	shin
cgi	cgi
sts	sts
wanna	wanna
greek	greek
ict	ict
duke	duke
columbia	columbia
solo	solo
orange	orange
print	print
input	input
brand	brand
terminal	terminal
forces	forces
ancient	ancient
neo	neo
phase	phase
bruce	bruce
chart	chart
commission	commission
tf	tf
vision	vision
better	better
always	always
hope	hope
wars	wars
universe	universe
samuel	samuel
wish	wish
cfg	cfg
pour	pour
half	half
spirit	spirit
description	description
foreign	foreign
rf	rf
mil	mil
pk	pk
edits	edits
roll	roll
tiger	tiger
kevin	kevin
coming	coming
since	since
aus	aus
storm	storm
beijing	beijing
things	things
hiv	hiv
ti	ti
traffic	traffic
anti	anti
patrick	patrick
metal	metal
extra	extra
fantasy	fantasy
mo	mo
capital	capital
update	update
citation	citation
sao	sao
q_	q_
tm	tm
store	store
nec	nec
trade	trade
cold	cold
account	account
moto	moto
dm	dm
discussion	discussion
fate	fate
antonio	antonio
anderson	anderson
fight	fight
indian	indian
agm	agm
nothing	nothing
ra	ra
num	num
margin	margin
lan	lan
rect	rect
fl	fl
nike	nike
independent	independent
portrait	portrait
snl	snl
spanish	spanish
etc	etc
andy	andy
save	save
howard	howard
given	given
chu	chu
animal	animal
ryan	ryan
remember	remember
missile	missile
k_	k_
layer	layer
cruz	cruz
professional	professional
caption	caption
iron	iron
destiny	destiny
justice	justice
diamond	diamond
victor	victor
walk	walk
bbs	bbs
mmorpg	mmorpg
ncaa	ncaa
enter	enter
television	television
cbc	cbc
matthew	matthew
fan	fan
structure	structure
wing	wing
harvard	harvard
sunday	sunday
rca	rca
fw	fw
glory	glory
saga	saga
sec	sec
everything	everything
keep	keep
ipa	ipa
symphony	symphony
bo	bo
cafe	cafe
unesco	unesco
aria	aria
tim	tim
jfk	jfk
ld	ld
goodbye	goodbye
eds	eds
cbe	cbe
xl	xl
⊙	⊙
alfred	alfred
friedrich	friedrich
economics	economics
npc	npc
cube	cube
agg	agg
words	words
symbol	symbol
authority	authority
samsung	samsung
apec	apec
various	various
ready	ready
staff	staff
i_	i_
roger	roger
jazz	jazz
gone	gone
rb	rb
vietnam	vietnam
minor	minor
jonathan	jonathan
hit	hit
shadow	shadow
own	own
wrestling	wrestling
bass	bass
beyond	beyond
does	does
camp	camp
kat	kat
move	move
s_	s_
winner	winner
wbc	wbc
canadian	canadian
known	known
las	las
working	working
communication	communication
archives	archives
vhs	vhs
late	late
nam	nam
ccd	ccd
bi	bi
executive	executive
bh	bh
memories	memories
floor	floor
prefix	prefix
challenge	challenge
close	close
mount	mount
gary	gary
features	features
ffd	ffd
append	append
alone	alone
statistics	statistics
mgm	mgm
cover	cover
african	african
abs	abs
reason	reason
float	float
favorite	favorite
product	product
philip	philip
period	period
cropped	cropped
blues	blues
faq	faq
hell	hell
cycling	cycling
missing	missing
kde	kde
bw	bw
bobby	bobby
kill	kill
living	living
в	в
ali	ali
virgin	virgin
knowledge	knowledge
itu	itu
fiction	fiction
direct	direct
venus	venus
usd	usd
michel	michel
private	private
medicine	medicine
doi	doi
electronic	electronic
details	details
vevo	vevo
quad	quad
billy	billy
caf	caf
rule	rule
miller	miller
mars	mars
lt	lt
iptv	iptv
и	и
tony	tony
hh	hh
yahoo	yahoo
forum	forum
brain	brain
dong	dong
gsm	gsm
devil	devil
ops	ops
gr	gr
della	della
math	math
rh	rh
tales	tales
jordan	jordan
gx	gx
convention	convention
pan	pan
create	create
solar	solar
eng	eng
reports	reports
once	once
pass	pass
engine	engine
million	million
cfc	cfc
scene	scene
theme	theme
nick	nick
fra	fra
random	random
tomorrow	tomorrow
sat	sat
preliminary	preliminary
forest	forest
gas	gas
az	az
shock	shock
yak	yak
uh	uh
mine	mine
paz	paz
pal	pal
agency	agency
greece	greece
agent	agent
values	values
card	card
honey	honey
him	him
acoustic	acoustic
ute	ute
utf	utf
γ	γ
wang	wang
pb	pb
lawrence	lawrence
application	application
crown	crown
null	null
codes	codes
fd	fd
marshall	marshall
election	election
paradise	paradise
police	police
pattern	pattern
doctor	doctor
vod	vod
wilhelm	wilhelm
weekly	weekly
ki	ki
fame	fame
intelligence	intelligence
stack	stack
poet	poet
multi	multi
char	char
ken	ken
chief	chief
scientific	scientific
root	root
yo	yo
sounds	sounds
gu	gu
zip	zip
ville	ville
syndrome	syndrome
princeton	princeton
slr	slr
sex	sex
crew	crew
lines	lines
faith	faith
within	within
vip	vip
gsub	gsub
jim	jim
zealand	zealand
personal	personal
hq	hq
johnny	johnny
arc	arc
cry	cry
interface	interface
globe	globe
entrance	entrance
factor	factor
hdtv	hdtv
tech	tech
icon	icon
path	path
boston	boston
mysql	mysql
douglas	douglas
bm	bm
feature	feature
singles	singles
iq	iq
ghost	ghost
exit	exit
tonight	tonight
active	active
position	position
npov	npov
kh	kh
rise	rise
treaty	treaty
clear	clear
cycle	cycle
pol	pol
think	think
victoria	victoria
sdram	sdram
sum	sum
dome	dome
era	era
sb	sb
exchange	exchange
ucla	ucla
luv	luv
railroad	railroad
ez	ez
shine	shine
freebsd	freebsd
gg	gg
intel	intel
nf	nf
thing	thing
classical	classical
fish	fish
oil	oil
cx	cx
gd	gd
ocean	ocean
ftp	ftp
hits	hits
flying	flying
relief	relief
champions	champions
boxing	boxing
origin	origin
sq	sq
nos	nos
templates	templates
urban	urban
delete	delete
matt	matt
daily	daily
bernard	bernard
elements	elements
court	court
app	app
tt	tt
l_	l_
stories	stories
something	something
care	care
cmos	cmos
zoom	zoom
deutsche	deutsche
trax	trax
gto	gto
scale	scale
fort	fort
georgia	georgia
sas	sas
interest	interest
brazil	brazil
dv	dv
yu	yu
dll	dll
flat	flat
theatre	theatre
lab	lab
pocket	pocket
resources	resources
shop	shop
village	village
donald	donald
could	could
pos	pos
tears	tears
esp	esp
coast	coast
threatened	threatened
campaign	campaign
turn	turn
window	window
watson	watson
rate	rate
fine	fine
monster	monster
dl	dl
hop	hop
ana	ana
week	week
federal	federal
construction	construction
popular	popular
journey	journey
seal	seal
img	img
several	several
ireland	ireland
rank	rank
ofc	ofc
democratic	democratic
trust	trust
ny	ny
ian	ian
broken	broken
jin	jin
primary	primary
experience	experience
kai	kai
cut	cut
canon	canon
papers	papers
britain	britain
chemical	chemical
logic	logic
beauty	beauty
pda	pda
inch	inch
congress	congress
tonumber	tonumber
yang	yang
guy	guy
multiple	multiple
config	config
generic	generic
documentary	documentary
jc	jc
midi	midi
benjamin	benjamin
biology	biology
sch	sch
jet	jet
manual	manual
youth	youth
sata	sata
ernst	ernst
empty	empty
fat	fat
angle	angle
heidelberg	heidelberg
grace	grace
parameters	parameters
wwf	wwf
maps	maps
selection	selection
selected	selected
mas	mas
ecw	ecw
pure	pure
wta	wta
extended	extended
whole	whole
alliance	alliance
moore	moore
put	put
select	select
tools	tools
je	je
bishop	bishop
address	address
glass	glass
poland	poland
aaron	aaron
mn	mn
dk	dk
finally	finally
rsssf	rsssf
pe	pe
rap	rap
bx	bx
baker	baker
wide	wide
semi	semi
aka	aka
training	training
birthday	birthday
qr	qr
those	those
molecular	molecular
physical	physical
centered	centered
hold	hold
jacques	jacques
junior	junior
creative	creative
switch	switch
taken	taken
mathematical	mathematical
intro	intro
ccl	ccl
école	école
limit	limit
earl	earl
sources	sources
sydney	sydney
politics	politics
craig	craig
sci	sci
giant	giant
vincent	vincent
circuit	circuit
ccc	ccc
d_	d_
cinema	cinema
cathedral	cathedral
religion	religion
communications	communications
iaaf	iaaf
params	params
lucky	lucky
fun	fun
environment	environment
cultural	cultural
route	route
om	om
cha	cha
lonely	lonely
transit	transit
sorry	sorry
tab	tab
theater	theater
try	try
irish	irish
jimmy	jimmy
subst	subst
soon	soon
π	π
kf	kf
snk	snk
returns	returns
wa	wa
joint	joint
rear	rear
rim	rim
aj	aj
catch	catch
imperial	imperial
ext	ext
adams	adams
ford	ford
crystal	crystal
related	related
uv	uv
regional	regional
franz	franz
hu	hu
cho	cho
fighter	fighter
fact	fact
called	called
<	<
dynamic	dynamic
sons	sons
fina	fina
goes	goes
robin	robin
upper	upper
johann	johann
virginia	virginia
functions	functions
crow	crow
gl	gl
sean	sean
presents	presents
israel	israel
papa	papa
sugar	sugar
musical	musical
trophy	trophy
iana	iana
options	options
characters	characters
protection	protection
bin	bin
recording	recording
dim	dim
han	han
luis	luis
price	price
leaf	leaf
fourth	fourth
fu	fu
pretty	pretty
pmc	pmc
ati	ati
italian	italian
impact	impact
kid	kid
edited	edited
cite	cite
tale	tale
μ	μ
done	done
operations	operations
exists	exists
clark	clark
lover	lover
palace	palace
š	š
element	element
copy	copy
strike	strike
suv	suv
latin	latin
fast	fast
kk	kk
bis	bis
featured	featured
crash	crash
jeff	jeff
father	father
heritage	heritage
christ	christ
classification	classification
dawn	dawn
purple	purple
frederick	frederick
android	android
nicholas	nicholas
array	array
wikitable	wikitable
voz	voz
eight	eight
kelly	kelly
xd	xd
pf	pf
lm	lm
possible	possible
adventure	adventure
lane	lane
request	request
grey	grey
mad	mad
charlie	charlie
fontsize	fontsize
gdi	gdi
apps	apps
includes	includes
mario	mario
sword	sword
ira	ira
esa	esa
satellite	satellite
wikitext	wikitext
p_i	p_i
heavy	heavy
str	str
mol	mol
ultra	ultra
juice	juice
nova	nova
homepage	homepage
obe	obe
viii	viii
warner	warner
boom	boom
strong	strong
cape	cape
hearts	hearts
ty	ty
going	going
script	script
gc	gc
builder	builder
rising	rising
door	door
dennis	dennis
letters	letters
chemistry	chemistry
changes	changes
less	less
lisa	lisa
person	person
jung	jung
luna	luna
bg	bg
rm	rm
russell	russell
ssn	ssn
output	output
mai	mai
ger	ger
tank	tank
marc	marc
screen	screen
nana	nana
listen	listen
bp	bp
engineer	engineer
eternal	eternal
industrial	industrial
sunshine	sunshine
producer	producer
evil	evil
masters	masters
austria	austria
vert	vert
viva	viva
course	course
£	£
def	def
transparent	transparent
much	much
pain	pain
administration	administration
escape	escape
argentina	argentina
unknown	unknown
iff	iff
writing	writing
lr	lr
mercedes	mercedes
xiii	xiii
sarah	sarah
stanley	stanley
ladies	ladies
mirror	mirror
mathematics	mathematics
melody	melody
nelson	nelson
atlas	atlas
stream	stream
combat	combat
node	node
horse	horse
verlag	verlag
barbara	barbara
ludwig	ludwig
panorama	panorama
spec	spec
depth	depth
counter	counter
signal	signal
bt	bt
rome	rome
industry	industry
thailand	thailand
storage	storage
vr	vr
japonica	japonica
studios	studios
seen	seen
theorem	theorem
dean	dean
rp	rp
cloud	cloud
written	written
moment	moment
lovely	lovely
perry	perry
covering	covering
zh	zh
brave	brave
ux	ux
wood	wood
angels	angels
madrid	madrid
tsv	tsv
infinity	infinity
ride	ride
aw	aw
dancing	dancing
roh	roh
academic	academic
lo	lo
campbell	campbell
boa	boa
val	val
qs	qs
mh	mh
ascii	ascii
relay	relay
pga	pga
terms	terms
collapsed	collapsed
matter	matter
hbo	hbo
wonderful	wonderful
sing	sing
vector	vector
phone	phone
nwa	nwa
overview	overview
wasp	wasp
giovanni	giovanni
pet	pet
stewart	stewart
egypt	egypt
locator	locator
higher	higher
ministry	ministry
automatic	automatic
atv	atv
concept	concept
airbus	airbus
rhythm	rhythm
past	past
aviation	aviation
purpose	purpose
gene	gene
ws	ws
literature	literature
tw	tw
enterprise	enterprise
monthly	monthly
dmc	dmc
θ	θ
rocket	rocket
factory	factory
contains	contains
behind	behind
leading	leading
jon	jon
transfer	transfer
bae	bae
quality	quality
loop	loop
otto	otto
ncc	ncc
discovery	discovery
pen	pen
victory	victory
bachelor	bachelor
conmebol	conmebol
lincoln	lincoln
feeling	feeling
minutes	minutes
singapore	singapore
fighting	fighting
alternative	alternative
virus	virus
vista	vista
pairs	pairs
stanford	stanford
og	og
offset	offset
ye	ye
netherlands	netherlands
colors	colors
wto	wto
nr	nr
legal	legal
numbers	numbers
ol	ol
angeles	angeles
thanks	thanks
llc	llc
robinson	robinson
miles	miles
zur	zur
chance	chance
heinrich	heinrich
quantum	quantum
wright	wright
corps	corps
britannica	britannica
dns	dns
lion	lion
contemporary	contemporary
harris	harris
pbs	pbs
ups	ups
even	even
quest	quest
cedar	cedar
cfa	cfa
hdmi	hdmi
takes	takes
graham	graham
colour	colour
françois	françois
rail	rail
editors	editors
kings	kings
translated	translated
nice	nice
distribution	distribution
atlantic	atlantic
std	std
franklin	franklin
reserve	reserve
moscow	moscow
toronto	toronto
assembly	assembly
lh	lh
kennedy	kennedy
py	py
rush	rush
resource	resource
morgan	morgan
ross	ross
arp	arp
chain	chain
hospital	hospital
billboard	billboard
ppm	ppm
sig	sig
pool	pool
sj	sj
blank	blank
khan	khan
disease	disease
captain	captain
ht	ht
travel	travel
gcc	gcc
u_	u_
joins	joins
ei	ei
aba	aba
groups	groups
ku	ku
zu	zu
fsv	fsv
collins	collins
mev	mev
surface	surface
qui	qui
eta	eta
allegro	allegro
miracle	miracle
chan	chan
σ	σ
everyday	everyday
raymond	raymond
campus	campus
dh	dh
wappen	wappen
tool	tool
issn	issn
rv	rv
tb	tb
rss	rss
aesa	aesa
ut	ut
ur	ur
qt	qt
um	um
fresh	fresh
arguments	arguments
bull	bull
connection	connection
issues	issues
heroes	heroes
taiwan	taiwan
thompson	thompson
cad	cad
dy	dy
others	others
clan	clan
ustring	ustring
ukraine	ukraine
grande	grande
upon	upon
outside	outside
lol	lol
guardian	guardian
histoire	histoire
processing	processing
python	python
foot	foot
broadcasting	broadcasting
romance	romance
kind	kind
ogg	ogg
toyota	toyota
steel	steel
hidden	hidden
pu	pu
disk	disk
vm	vm
ronald	ronald
wd	wd
aspx	aspx
role	role
buddha	buddha
bild	bild
yet	yet
camera	camera
φ	φ
din	din
bmg	bmg
survey	survey
drop	drop
albums	albums
itunes	itunes
sense	sense
tp	tp
johannes	johannes
hal	hal
ave	ave
copyright	copyright
mixed	mixed
ret	ret
район	район
friday	friday
inter	inter
eddie	eddie
gift	gift
jacob	jacob
sonic	sonic
warning	warning
oliver	oliver
danny	danny
fuel	fuel
families	families
rules	rules
io	io
mystery	mystery
cherry	cherry
neil	neil
affairs	affairs
basketball	basketball
safety	safety
dei	dei
disney	disney
posix	posix
hsdpa	hsdpa
soft	soft
ted	ted
eagle	eagle
really	really
sar	sar
xhtml	xhtml
larry	larry
candy	candy
crest	crest
identification	identification
walker	walker
manchester	manchester
interactive	interactive
infobox	infobox
hands	hands
later	later
cook	cook
bomb	bomb
sites	sites
critical	critical
include	include
routledge	routledge
ballad	ballad
problems	problems
ε	ε
por	por
seti	seti
midnight	midnight
bone	bone
products	products
dom	dom
speech	speech
grant	grant
florida	florida
term	term
robot	robot
astronomy	astronomy
wu	wu
carter	carter
pic	pic
herbert	herbert
liberty	liberty
shield	shield
maintenance	maintenance
w_	w_
ke	ke
conservation	conservation
maximum	maximum
standards	standards
material	material
coins	coins
soundtrack	soundtrack
clock	clock
manager	manager
rider	rider
argument	argument
eggs	eggs
eva	eva
sunset	sunset
scheme	scheme
aid	aid
documents	documents
artists	artists
rtl	rtl
arxiv	arxiv
ao	ao
task	task
birth	birth
ri	ri
zoo	zoo
slow	slow
lu	lu
nous	nous
evans	evans
circus	circus
fever	fever
guard	guard
soc	soc
ji	ji
loc	loc
transport	transport
push	push
hunter	hunter
brt	brt
prix	prix
honor	honor
strange	strange
с	с
henri	henri
definition	definition
diving	diving
response	response
updated	updated
means	means
lim	lim
kfc	kfc
gravity	gravity
require	require
meet	meet
mammals	mammals
springer	springer
duet	duet
laser	laser
running	running
launch	launch
gloria	gloria
vt	vt
trial	trial
oclc	oclc
lsd	lsd
shark	shark
amg	amg
heading	heading
killer	killer
ju	ju
senior	senior
until	until
ist	ist
extension	extension
pas	pas
euro	euro
bonus	bonus
shall	shall
laboratory	laboratory
tail	tail
protein	protein
flip	flip
spd	spd
places	places
sort	sort
va	va
rich	rich
det	det
decision	decision
µm	µm
wow	wow
aids	aids
lie	lie
laura	laura
mag	mag
talks	talks
bible	bible
ending	ending
chang	chang
lgbt	lgbt
iran	iran
oem	oem
pac	pac
j_	j_
iss	iss
dem	dem
detail	detail
murder	murder
tl	tl
triple	triple
sweden	sweden
former	former
miguel	miguel
barry	barry
ik	ik
kernel	kernel
practice	practice
triangle	triangle
handbook	handbook
canal	canal
references	references
fixed	fixed
julian	julian
ddg	ddg
sdk	sdk
soccer	soccer
kx	kx
initial	initial
tx	tx
gap	gap
lead	lead
beginning	beginning
produced	produced
novel	novel
vienna	vienna
indonesia	indonesia
jo	jo
standing	standing
holiday	holiday
rsc	rsc
tracks	tracks
dg	dg
λ	λ
boat	boat
icd	icd
tj	tj
desire	desire
gilbert	gilbert
ul	ul
diagram	diagram
resolution	resolution
countdown	countdown
career	career
une	une
amc	amc
polish	polish
package	package
poly	poly
videos	videos
publishers	publishers
monkey	monkey
least	least
harper	harper
lyon	lyon
gmt	gmt
parts	parts
whip	whip
roy	roy
bundesarchiv	bundesarchiv
unix	unix
ton	ton
financial	financial
cancer	cancer
ccff	ccff
ultimate	ultimate
yyyy	yyyy
rapid	rapid
usl	usl
jorge	jorge
mean	mean
artistic	artistic
nor	nor
shell	shell
tommy	tommy
hybrid	hybrid
ipairs	ipairs
funk	funk
oblast	oblast
hungary	hungary
shake	shake
xm	xm
ranking	ranking
portugal	portugal
motor	motor
shows	shows
required	required
acm	acm
write	write
frequency	frequency
units	units
member	member
rg	rg
potter	potter
catherine	catherine
shanghai	shanghai
atom	atom
norman	norman
static	static
powers	powers
strings	strings
monument	monument
economy	economy
remove	remove
however	however
abstract	abstract
nacional	nacional
vehicle	vehicle
blind	blind
fantastic	fantastic
pride	pride
austin	austin
wayne	wayne
growth	growth
gmbh	gmbh
jerry	jerry
lovers	lovers
manuel	manuel
scotland	scotland
chairman	chairman
jose	jose
ua	ua
added	added
frankfurt	frankfurt
branch	branch
icc	icc
makes	makes
hills	hills
namespace	namespace
avenue	avenue
wiley	wiley
defence	defence
external	external
teen	teen
mercury	mercury
follow	follow
creek	creek
andrea	andrea
click	click
column	column
harold	harold
rest	rest
job	job
looking	looking
mouse	mouse
skin	skin
bear	bear
hollywood	hollywood
browser	browser
aero	aero
everybody	everybody
jennifer	jennifer
phoenix	phoenix
berkeley	berkeley
junction	junction
session	session
phantom	phantom
boss	boss
thought	thought
build	build
soundcloud	soundcloud
morris	morris
fcc	fcc
championships	championships
historic	historic
movies	movies
bafta	bafta
expo	expo
portable	portable
wb	wb
ivan	ivan
hamilton	hamilton
clean	clean
reading	reading
origins	origins
brad	brad
micro	micro
claude	claude
crisis	crisis
rex	rex
eugene	eugene
woo	woo
dutch	dutch
subject	subject
wan	wan
yb	yb
margaret	margaret
edwards	edwards
minute	minute
yeah	yeah
risc	risc
sys	sys
essays	essays
georg	georg
crc	crc
compact	compact
fuck	fuck
strategy	strategy
sus	sus
mama	mama
beast	beast
marco	marco
diva	diva
ncbi	ncbi
arab	arab
chen	chen
xe	xe
waiting	waiting
ccm	ccm
iraq	iraq
meeting	meeting
iphone	iphone
prefecture	prefecture
cdu	cdu
effects	effects
dual	dual
valid	valid
barcelona	barcelona
andreas	andreas
bat	bat
query	query
notice	notice
built	built
myself	myself
beats	beats
matrix	matrix
xxxx	xxxx
answer	answer
load	load
nobody	nobody
territory	territory
officer	officer
democracy	democracy
wee	wee
wm	wm
vb	vb
medium	medium
ips	ips
nb	nb
extreme	extreme
specific	specific
networks	networks
legacy	legacy
solution	solution
dynasty	dynasty
sol	sol
saints	saints
directx	directx
medley	medley
cause	cause
shuffle	shuffle
throw	throw
graduate	graduate
specialist	specialist
malaysia	malaysia
pj	pj
cern	cern
device	device
flora	flora
stock	stock
ssd	ssd
blitz	blitz
success	success
emperor	emperor
georges	georges
sheet	sheet
graphics	graphics
escudo	escudo
arch	arch
maybe	maybe
kj	kj
axis	axis
arnold	arnold
institut	institut
merry	merry
‡	‡
leader	leader
adobe	adobe
item	item
happiness	happiness
abu	abu
jewish	jewish
projects	projects
raf	raf
vga	vga
encyclopaedia	encyclopaedia
ifc	ifc
classics	classics
diego	diego
ω	ω
sailing	sailing
polo	polo
commercial	commercial
imdb	imdb
nate	nate
yale	yale
question	question
sand	sand
erik	erik
plc	plc
nxt	nxt
reality	reality
join	join
documentation	documentation
reich	reich
tribute	tribute
focus	focus
spot	spot
jj	jj
contributions	contributions
≈	≈
greg	greg
optical	optical
za	za
guns	guns
bandera	bandera
constitution	constitution
bulgaria	bulgaria
computing	computing
internal	internal
seymour	seymour
carrier	carrier
hc	hc
mos	mos
tea	tea
uses	uses
msn	msn
ck	ck
esrb	esrb
players	players
bureau	bureau
cities	cities
_whiteshoulders	_whiteshoulders
olivia	olivia
rolling	rolling
grammar	grammar
silent	silent
stripes	stripes
res	res
materials	materials
lock	lock
ein	ein
dans	dans
student	student
tk	tk
darkness	darkness
identity	identity
geographic	geographic
ron	ron
hole	hole
cz	cz
canis	canis
y_i	y_i
gen	gen
mrna	mrna
dick	dick
pin	pin
credit	credit
supreme	supreme
wings	wings
framework	framework
liu	liu
bio	bio
pcb	pcb
bee	bee
tekken	tekken
premium	premium
rosso	rosso
mach	mach
weather	weather
hb	hb
phil	phil
said	said
minister	minister
puzzle	puzzle
chaos	chaos
might	might
applications	applications
hate	hate
goods	goods
ward	ward
paulo	paulo
trim	trim
fin	fin
among	among
invasion	invasion
dagger	dagger
stuart	stuart
already	already
lot	lot
sps	sps
atr	atr
mq	mq
linear	linear
chile	chile
interior	interior
positive	positive
iris	iris
mips	mips
aol	aol
sx	sx
idea	idea
medieval	medieval
groove	groove
created	created
txt	txt
▪	▪
keith	keith
tam	tam
vp	vp
mountains	mountains
zeta	zeta
sniper	sniper
twenty	twenty
parallel	parallel
wien	wien
sds	sds
vc	vc
specification	specification
bv	bv
produce	produce
thumb	thumb
desert	desert
agreement	agreement
falling	falling
marcus	marcus
ain	ain
gh	gh
≤	≤
conflict	conflict
len	len
kenneth	kenneth
o_	o_
buffalo	buffalo
sitenotice	sitenotice
evidence	evidence
wait	wait
catalog	catalog
inner	inner
cells	cells
parker	parker
spy	spy
ttl	ttl
innovation	innovation
split	split
due	due
yesterday	yesterday
distance	distance
msm	msm
mega	mega
duo	duo
cooper	cooper
sad	sad
julia	julia
ich	ich
demo	demo
justin	justin
trick	trick
leave	leave
flowers	flowers
yi	yi
warren	warren
relations	relations
passion	passion
taipei	taipei
button	button
bush	bush
dhl	dhl
eclipse	eclipse
hm	hm
pdp	pdp
equus	equus
roma	roma
proceedings	proceedings
opening	opening
wnba	wnba
susan	susan
important	important
detailed	detailed
hugh	hugh
risk	risk
univ	univ
psychology	psychology
opengl	opengl
explorer	explorer
vita	vita
integer	integer
span	span
coffee	coffee
par	par
airways	airways
dry	dry
draft	draft
rosa	rosa
principles	principles
plate	plate
liberal	liberal
jeffrey	jeffrey
fashion	fashion
murray	murray
lives	lives
newton	newton
meaning	meaning
crime	crime
faculty	faculty
faa	faa
jersey	jersey
eve	eve
illinois	illinois
farm	farm
wesley	wesley
sans	sans
pine	pine
eat	eat
variable	variable
loves	loves
myth	myth
members	members
oscar	oscar
radar	radar
parade	parade
usp	usp
pieces	pieces
pedro	pedro
roberts	roberts
register	register
reed	reed
vu	vu
auf	auf
gmc	gmc
plaza	plaza
loving	loving
fp	fp
nz	nz
writer	writer
trip	trip
lists	lists
kate	kate
tn	tn
cake	cake
fv	fv
promise	promise
mrs	mrs
rus	rus
greater	greater
cola	cola
tables	tables
collapse	collapse
bpm	bpm
ietf	ietf
ddt	ddt
salt	salt
hitler	hitler
gay	gay
hg	hg
bn	bn
rem	rem
hn	hn
apt	apt
gf	gf
ipc	ipc
cost	cost
benz	benz
exhibition	exhibition
philippines	philippines
jerusalem	jerusalem
formation	formation
galapagos	galapagos
fred	fred
marketing	marketing
sister	sister
mitchell	mitchell
dirty	dirty
tribe	tribe
vie	vie
spc	spc
suite	suite
goal	goal
amy	amy
tostring	tostring
michigan	michigan
italia	italia
villa	villa
degree	degree
option	option
aps	aps
illustrated	illustrated
projection	projection
needed	needed
turner	turner
ogle	ogle
dash	dash
wales	wales
texts	texts
gregory	gregory
philippe	philippe
denmark	denmark
ρ	ρ
echo	echo
derek	derek
shakespeare	shakespeare
fear	fear
whale	whale
fleet	fleet
provided	provided
cluster	cluster
rachel	rachel
comes	comes
louise	louise
named	named
activity	activity
passed	passed
promotion	promotion
commander	commander
ou	ou
wr	wr
rudolf	rudolf
negative	negative
accessdate	accessdate
cole	cole
jessica	jessica
unicode	unicode
contents	contents
wrong	wrong
serbia	serbia
across	across
birds	birds
gabriel	gabriel
pak	pak
integrated	integrated
sierra	sierra
municipal	municipal
bon	bon
qf	qf
golf	golf
xa	xa
amazon	amazon
cosmic	cosmic
lloyd	lloyd
alias	alias
ads	ads
trail	trail
directory	directory
bmp	bmp
partners	partners
itf	itf
gi	gi
chamber	chamber
silva	silva
brother	brother
kansas	kansas
isa	isa
fao	fao
finance	finance
nobel	nobel
rob	rob
crh	crh
combined	combined
ajax	ajax
magnetic	magnetic
voices	voices
mri	mri
coach	coach
behavior	behavior
summit	summit
isp	isp
facelift	facelift
figure	figure
swan	swan
„	„
ansi	ansi
ernest	ernest
cis	cis
burning	burning
falls	falls
gear	gear
xs	xs
driver	driver
suit	suit
kbps	kbps
rifle	rifle
assistant	assistant
rescue	rescue
raid	raid
lf	lf
countries	countries
carolina	carolina
capture	capture
olympus	olympus
enough	enough
lights	lights
notre	notre
guinea	guinea
telescope	telescope
che	che
chip	chip
dz	dz
pack	pack
moving	moving
applied	applied
observatory	observatory
contact	contact
soldier	soldier
gee	gee
lucy	lucy
wolfgang	wolfgang
lucas	lucas
brief	brief
cal	cal
tone	tone
planets	planets
tgv	tgv
fda	fda
worlds	worlds
hermann	hermann
eax	eax
approach	approach
redirect	redirect
viola	viola
seo	seo
macmillan	macmillan
maurice	maurice
ralph	ralph
dlc	dlc
costa	costa
principle	principle
spin	spin
thistle	thistle
cox	cox
lx	lx
chase	chase
para	para
cohen	cohen
carlo	carlo
judo	judo
schools	schools
noble	noble
cargo	cargo
ferdinand	ferdinand
thy	thy
geschichte	geschichte
doug	doug
nebula	nebula
illusion	illusion
hide	hide
fairy	fairy
leon	leon
lgpl	lgpl
sul	sul
cortex	cortex
stade	stade
dogs	dogs
straight	straight
sha	sha
ins	ins
naked	naked
autumn	autumn
charlotte	charlotte
dsc	dsc
ask	ask
xii	xii
amazing	amazing
sang	sang
norton	norton
calling	calling
philadelphia	philadelphia
ard	ard
ruby	ruby
cream	cream
hyper	hyper
belgium	belgium
mon	mon
statue	statue
baltimore	baltimore
norway	norway
bu	bu
swing	swing
asa	asa
massachusetts	massachusetts
banner	banner
photographs	photographs
occupation	occupation
property	property
sz	sz
slave	slave
chorus	chorus
finland	finland
municipality	municipality
_whiteborder	_whiteborder
bring	bring
nationale	nationale
drums	drums
bright	bright
dame	dame
ppp	ppp
leonard	leonard
laws	laws
separator	separator
oled	oled
famous	famous
atomic	atomic
duck	duck
reborn	reborn
rice	rice
joshua	joshua
michelle	michelle
ban	ban
coo	coo
progress	progress
properties	properties
parliament	parliament
dur	dur
algorithm	algorithm
congo	congo
foster	foster
colin	colin
genesis	genesis
annual	annual
hugo	hugo
cam	cam
aip	aip
infinite	infinite
theology	theology
twilight	twilight
joan	joan
gq	gq
ctc	ctc
native	native
bread	bread
descriptions	descriptions
ntsc	ntsc
bmi	bmi
andré	andré
baron	baron
rw	rw
met	met
aux	aux
pearl	pearl
noise	noise
trouble	trouble
история	история
associated	associated
developer	developer
terry	terry
accessed	accessed
oss	oss
lite	lite
ssi	ssi
authors	authors
qwerty	qwerty
environmental	environmental
everyone	everyone
jg	jg
someone	someone
cdc	cdc
traditional	traditional
jumping	jumping
hudson	hudson
highway	highway
fund	fund
additional	additional
alberto	alberto
landing	landing
binary	binary
athens	athens
nj	nj
aq	aq
wagner	wagner
bel	bel
cyber	cyber
concerto	concerto
hf	hf
francesco	francesco
creation	creation
denis	denis
gran	gran
adrian	adrian
consumer	consumer
gill	gill
vh	vh
cnbc	cnbc
rq	rq
navbox	navbox
testing	testing
presidential	presidential
divine	divine
racing	racing
according	according
precision	precision
reviews	reviews
yourself	yourself
tai	tai
f_i	f_i
holland	holland
resistance	resistance
involved	involved
fortune	fortune
comic	comic
stadion	stadion
ide	ide
lepus	lepus
pablo	pablo
define	define
custom	custom
fernando	fernando
independence	independence
dev	dev
fortress	fortress
nippon	nippon
tape	tape
carol	carol
bradley	bradley
eco	eco
wells	wells
hair	hair
houston	houston
comparison	comparison
reverse	reverse
hook	hook
parent	parent
nme	nme
jd	jd
lin	lin
drawing	drawing
saturday	saturday
insignia	insignia
dive	dive
sunrise	sunrise
pia	pia
gibson	gibson
planning	planning
sunny	sunny
macdonald	macdonald
thousand	thousand
serial	serial
españa	españa
ing	ing
epic	epic
pat	pat
swiss	swiss
hammer	hammer
ole	ole
nfc	nfc
sung	sung
interwiki	interwiki
chocolate	chocolate
nw	nw
understanding	understanding
czech	czech
sri	sri
ars	ars
rfid	rfid
corp	corp
renault	renault
hopkins	hopkins
worldwide	worldwide
along	along
ibn	ibn
questions	questions
cited	cited
implementation	implementation
tap	tap
matches	matches
penguin	penguin
ships	ships
avc	avc
moonlight	moonlight
entity	entity
panzer	panzer
programme	programme
weapons	weapons
b_n	b_n
vocals	vocals
mbe	mbe
wtc	wtc
trinity	trinity
platinum	platinum
population	population
nano	nano
jupiter	jupiter
objects	objects
hunt	hunt
egg	egg
apollo	apollo
encore	encore
either	either
laurent	laurent
horizon	horizon
lil	lil
f_n	f_n
msdn	msdn
spider	spider
dust	dust
lens	lens
singer	singer
wildlife	wildlife
blade	blade
cms	cms
uri	uri
dates	dates
fried	fried
genus	genus
allan	allan
günther	günther
на	на
abbey	abbey
gospel	gospel
hdr	hdr
mask	mask
__	__
joker	joker
arkive	arkive
maría	maría
nn	nn
soap	soap
passenger	passenger
angela	angela
ldh	ldh
tex	tex
visualeditor	visualeditor
calendar	calendar
fifth	fifth
defined	defined
jeremy	jeremy
share	share
essay	essay
nicolas	nicolas
interlude	interlude
burn	burn
jefferson	jefferson
globalsecurity	globalsecurity
shining	shining
apache	apache
filter	filter
≠	≠
temp	temp
romania	romania
distributed	distributed
zz	zz
dangerous	dangerous
fg	fg
т	т
lynn	lynn
rage	rage
loser	loser
pennsylvania	pennsylvania
riaa	riaa
fischer	fischer
pick	pick
hawk	hawk
eh	eh
wallace	wallace
landscape	landscape
pid	pid
sid	sid
fpga	fpga
wisdom	wisdom
über	über
mazda	mazda
gnome	gnome
methods	methods
η	η
gonna	gonna
rer	rer
a_i	a_i
bce	bce
keys	keys
fighters	fighters
nord	nord
este	este
murphy	murphy
deal	deal
bing	bing
wba	wba
swift	swift
rsa	rsa
kl	kl
iia	iia
sap	sap
seat	seat
soldiers	soldiers
deg	deg
participation	participation
oriental	oriental
xiv	xiv
fit	fit
convert	convert
bloody	bloody
proc	proc
roberto	roberto
underground	underground
diversity	diversity
mca	mca
rick	rick
hood	hood
feet	feet
holdings	holdings
tha	tha
hours	hours
werner	werner
breaking	breaking
lecture	lecture
animals	animals
grave	grave
goto	goto
revised	revised
cases	cases
tourism	tourism
publication	publication
turkey	turkey
vegas	vegas
twin	twin
historia	historia
santiago	santiago
nintendo	nintendo
curtis	curtis
idol	idol
disco	disco
kal	kal
bulletin	bulletin
locked	locked
helen	helen
abraham	abraham
beck	beck
eg	eg
sharp	sharp
demi	demi
nigra	nigra
illustrations	illustrations
pump	pump
marina	marina
whitney	whitney
ion	ion
condition	condition
osi	osi
gymnastics	gymnastics
dir	dir
billion	billion
wireless	wireless
ign	ign
rms	rms
instruction	instruction
hockey	hockey
roundel	roundel
seasons	seasons
butler	butler
rai	rai
schneider	schneider
evening	evening
otherwise	otherwise
trap	trap
chronicle	chronicle
poems	poems
ctrl	ctrl
educational	educational
expression	expression
xc	xc
kent	kent
bless	bless
gods	gods
attr	attr
verbal	verbal
regular	regular
squirrel	squirrel
esperanto	esperanto
legends	legends
richardson	richardson
indiana	indiana
strategic	strategic
munich	munich
dram	dram
factbook	factbook
afghanistan	afghanistan
puerto	puerto
sara	sara
sullivan	sullivan
tip	tip
hart	hart
anthem	anthem
investigation	investigation
navigation	navigation
pub	pub
climate	climate
taking	taking
pie	pie
jna	jna
wonderland	wonderland
held	held
ay	ay
dq	dq
submarine	submarine
adventures	adventures
glenn	glenn
ssl	ssl
somebody	somebody
eden	eden
astronomical	astronomical
provides	provides
pywikipedia	pywikipedia
maker	maker
taxi	taxi
verde	verde
prism	prism
repair	repair
reader	reader
download	download
ucl	ucl
palm	palm
draw	draw
addclass	addclass
romantic	romantic
jt	jt
vancouver	vancouver
tor	tor
nancy	nancy
sure	sure
starcraft	starcraft
sixth	sixth
sodium	sodium
ideas	ideas
nih	nih
aes	aes
experimental	experimental
surgery	surgery
adult	adult
philippine	philippine
stockholm	stockholm
formula	formula
playstation	playstation
mir	mir
absolute	absolute
harbor	harbor
configuration	configuration
phd	phd
м	м
croatia	croatia
millennium	millennium
pcr	pcr
tunnel	tunnel
warrior	warrior
silence	silence
provincia	provincia
actor	actor
cas	cas
saw	saw
iga	iga
merit	merit
grid	grid
suffix	suffix
sequence	sequence
mile	mile
wedding	wedding
acorn	acorn
fritz	fritz
schedule	schedule
zf	zf
signed	signed
agp	agp
timothy	timothy
beam	beam
edwin	edwin
electronics	electronics
mechanics	mechanics
presentation	presentation
warfare	warfare
kurt	kurt
ensemble	ensemble
anything	anything
gang	gang
teenage	teenage
forget	forget
fellow	fellow
psycho	psycho
geo	geo
philosophical	philosophical
dell	dell
libya	libya
horn	horn
speak	speak
direction	direction
harmony	harmony
ned	ned
photography	photography
supported	supported
toy	toy
apc	apc
vice	vice
mom	mom
müller	müller
panic	panic
arg	arg
peer	peer
mythology	mythology
experiment	experiment
holding	holding
corresponding	corresponding
floating	floating
sometimes	sometimes
são	são
osprey	osprey
voyage	voyage
asean	asean
una	una
host	host
few	few
tomb	tomb
resort	resort
bug	bug
visit	visit
wolves	wolves
wire	wire
emily	emily
wine	wine
bibliography	bibliography
unique	unique
powerpc	powerpc
spencer	spencer
sy	sy
hughes	hughes
tropical	tropical
azerbaijan	azerbaijan
liberation	liberation
p_n	p_n
gustav	gustav
patch	patch
edinburgh	edinburgh
vo	vo
editing	editing
flame	flame
harp	harp
alba	alba
rn	rn
located	located
bbb	bbb
initiative	initiative
cellspacing	cellspacing
eq	eq
ninja	ninja
perl	perl
fussballdaten	fussballdaten
enemy	enemy
further	further
kit	kit
harrison	harrison
valencia	valencia
calvin	calvin
montenegro	montenegro
pressure	pressure
qu	qu
cent	cent
stefan	stefan
timeline	timeline
technologies	technologies
ticket	ticket
xf	xf
recorded	recorded
britney	britney
lua	lua
eur	eur
jonas	jonas
cast	cast
jesse	jesse
senate	senate
als	als
getting	getting
facts	facts
schmidt	schmidt
dw	dw
acl	acl
catalogue	catalogue
came	came
tube	tube
corporate	corporate
harvey	harvey
aac	aac
failure	failure
mma	mma
mustela	mustela
skip	skip
nsa	nsa
champion	champion
chicken	chicken
rad	rad
funky	funky
τ	τ
gy	gy
reprise	reprise
loss	loss
religious	religious
crt	crt
premier	premier
plastic	plastic
stem	stem
wizard	wizard
months	months
chef	chef
hawaii	hawaii
cello	cello
bryan	bryan
bennett	bennett
artificial	artificial
bow	bow
xo	xo
pw	pw
grade	grade
cmyk	cmyk
frs	frs
companion	companion
stub	stub
rpc	rpc
anton	anton
johns	johns
beatles	beatles
crop	crop
holmes	holmes
klaus	klaus
drum	drum
kung	kung
cornell	cornell
hurricane	hurricane
isis	isis
genius	genius
luke	luke
lily	lily
sls	sls
milan	milan
needs	needs
types	types
canvas	canvas
tyler	tyler
clifford	clifford
difference	difference
folk	folk
messages	messages
scottish	scottish
armstrong	armstrong
ppi	ppi
iib	iib
secretary	secretary
snp	snp
universität	universität
labor	labor
literary	literary
monday	monday
errors	errors
afp	afp
wheel	wheel
mozilla	mozilla
biz	biz
excerpt	excerpt
elementary	elementary
fisher	fisher
terror	terror
leslie	leslie
spaces	spaces
syria	syria
shaw	shaw
paolo	paolo
trio	trio
terra	terra
recordings	recordings
kick	kick
julius	julius
wc	wc
sample	sample
hamburg	hamburg
requiem	requiem
münchen	münchen
shape	shape
took	took
desktop	desktop
cats	cats
diana	diana
ata	ata
afi	afi
а	а
leadership	leadership
drug	drug
walking	walking
emergency	emergency
dvb	dvb
xv	xv
thomson	thomson
witch	witch
ο	ο
cy	cy
yuri	yuri
pn	pn
clarke	clarke
transformation	transformation
emma	emma
maxim	maxim
stevens	stevens
nat	nat
budapest	budapest
temperature	temperature
edgar	edgar
amoled	amoled
macy	macy
skyline	skyline
zhang	zhang
­	­
theological	theological
treasure	treasure
painting	painting
jstor	jstor
anime	anime
eo	eo
glados	glados
bones	bones
switzerland	switzerland
interscope	interscope
mall	mall
belle	belle
roots	roots
cop	cop
dimension	dimension
wikis	wikis
integration	integration
universities	universities
brigade	brigade
wo	wo
nicole	nicole
otrs	otrs
qq	qq
wife	wife
mate	mate
transportation	transportation
armed	armed
showing	showing
yf	yf
dio	dio
gerald	gerald
rené	rené
allied	allied
potential	potential
meyer	meyer
context	context
amsterdam	amsterdam
poker	poker
canyon	canyon
iupac	iupac
cid	cid
iai	iai
charge	charge
equipment	equipment
arte	arte
sandbox	sandbox
pair	pair
§	§
hardware	hardware
charts	charts
chelsea	chelsea
ssh	ssh
gba	gba
therefore	therefore
detective	detective
geoffrey	geoffrey
yoko	yoko
isaac	isaac
rko	rko
gundam	gundam
linda	linda
gala	gala
vote	vote
thunder	thunder
luck	luck
amour	amour
tri	tri
specified	specified
gender	gender
lies	lies
genetic	genetic
comprehensive	comprehensive
vous	vous
trance	trance
finish	finish
mcgraw	mcgraw
arrow	arrow
quick	quick
tui	tui
killing	killing
gaming	gaming
ill	ill
recovery	recovery
pmid	pmid
roc	roc
mime	mime
christianity	christianity
⅓	⅓
mia	mia
luftwaffe	luftwaffe
karen	karen
ages	ages
cameron	cameron
eine	eine
sepc	sepc
ways	ways
kenny	kenny
rtf	rtf
corpus	corpus
qa	qa
fia	fia
sexual	sexual
deutschland	deutschland
internationale	internationale
spa	spa
mexican	mexican
ellen	ellen
able	able
imaging	imaging
josef	josef
ellis	ellis
jpl	jpl
carbon	carbon
château	château
meets	meets
frost	frost
chuck	chuck
adolf	adolf
ark	ark
whether	whether
hy	hy
aerial	aerial
winning	winning
drew	drew
flickr	flickr
isle	isle
monte	monte
ζ	ζ
renaissance	renaissance
considered	considered
umno	umno
wanted	wanted
luigi	luigi
cash	cash
lotus	lotus
horizontal	horizontal
pakistan	pakistan
vladimir	vladimir
ashley	ashley
massacre	massacre
ß	ß
koch	koch
treatment	treatment
having	having
seventh	seventh
dynamics	dynamics
gates	gates
outstanding	outstanding
bros	bros
_r	_r
forms	forms
similar	similar
hsbc	hsbc
patricia	patricia
nyc	nyc
siege	siege
growing	growing
soyuz	soyuz
hack	hack
islamic	islamic
pole	pole
translate	translate
graphic	graphic
amor	amor
joel	joel
nad	nad
turbo	turbo
я	я
scsi	scsi
component	component
europa	europa
pilot	pilot
contest	contest
peters	peters
lynx	lynx
rod	rod
boyz	boyz
sup	sup
particle	particle
vx	vx
dominic	dominic
powell	powell
kara	kara
dvi	dvi
phillips	phillips
ones	ones
doll	doll
emotion	emotion
aix	aix
garcía	garcía
tar	tar
homo	homo
claims	claims
napoleon	napoleon
gets	gets
lose	lose
investment	investment
secure	secure
a_k	a_k
cfo	cfo
javier	javier
saudi	saudi
pete	pete
punk	punk
cave	cave
statement	statement
haven	haven
sed	sed
docs	docs
drm	drm
rogers	rogers
acc	acc
keyboard	keyboard
destination	destination
plane	plane
sisters	sisters
directed	directed
sebastian	sebastian
trees	trees
teacher	teacher
banks	banks
fur	fur
pframe	pframe
alien	alien
comedy	comedy
seconds	seconds
prayer	prayer
equation	equation
ontario	ontario
existence	existence
lightning	lightning
cuba	cuba
dee	dee
peak	peak
safe	safe
amp	amp
contract	contract
orientation	orientation
appendchild	appendchild
constant	constant
ast	ast
crossing	crossing
amx	amx
romeo	romeo
slam	slam
zdf	zdf
alison	alison
düsseldorf	düsseldorf
nbl	nbl
xor	xor
rare	rare
sudan	sudan
gtx	gtx
montana	montana
soccerway	soccerway
radiation	radiation
todd	todd
fletcher	fletcher
bet	bet
tune	tune
finale	finale
h_n	h_n
demand	demand
muscle	muscle
poor	poor
ohio	ohio
sen	sen
infantry	infantry
tma	tma
japonicus	japonicus
elle	elle
elf	elf
lk	lk
chair	chair
simpson	simpson
liquid	liquid
thinking	thinking
amr	amr
angelo	angelo
choir	choir
perspective	perspective
bonnie	bonnie
felix	felix
revenge	revenge
halo	halo
tlc	tlc
vulpes	vulpes
woods	woods
xb	xb
appearance	appearance
fruit	fruit
nathan	nathan
ciudad	ciudad
trilogy	trilogy
française	française
friendship	friendship
collected	collected
electron	electron
dublin	dublin
duncan	duncan
sophia	sophia
mighty	mighty
marks	marks
tres	tres
manhattan	manhattan
beverly	beverly
knows	knows
collaboration	collaboration
assessment	assessment
zum	zum
miranda	miranda
roses	roses
quiet	quiet
guilty	guilty
dts	dts
certain	certain
garcia	garcia
sacred	sacred
gil	gil
carry	carry
vida	vida
addison	addison
marathon	marathon
instead	instead
starting	starting
squad	squad
avg	avg
marsh	marsh
categories	categories
frog	frog
eleven	eleven
salvador	salvador
avi	avi
oasis	oasis
gott	gott
brandon	brandon
reaction	reaction
lux	lux
maya	maya
christine	christine
tus	tus
marcel	marcel
giorgio	giorgio
almost	almost
aig	aig
bruno	bruno
gare	gare
marvel	marvel
nigeria	nigeria
mason	mason
beer	beer
lyrics	lyrics
reprinted	reprinted
extrasolar	extrasolar
teaching	teaching
cannon	cannon
velvet	velvet
battalion	battalion
sysop	sysop
darling	darling
pit	pit
thaad	thaad
skull	skull
testament	testament
webelements	webelements
ear	ear
git	git
julie	julie
lazy	lazy
udp	udp
playing	playing
spiral	spiral
aut	aut
bunny	bunny
herman	herman
yugoslavia	yugoslavia
epa	epa
proof	proof
versions	versions
radius	radius
acts	acts
mercy	mercy
engineers	engineers
maritime	maritime
hannah	hannah
therapy	therapy
syn	syn
github	github
andre	andre
ecm	ecm
ego	ego
thrust	thrust
monitor	monitor
kgb	kgb
nights	nights
carnival	carnival
gbu	gbu
alaska	alaska
operator	operator
photographic	photographic
orbit	orbit
astro	astro
devices	devices
comics	comics
libera	libera
eduardo	eduardo
patria	patria
μm	μm
tradition	tradition
theodore	theodore
colony	colony
psa	psa
boot	boot
processor	processor
asin	asin
colonial	colonial
starring	starring
vos	vos
says	says
peru	peru
admiral	admiral
oe	oe
cellpadding	cellpadding
structures	structures
socialist	socialist
luca	luca
vor	vor
commerce	commerce
lou	lou
compilation	compilation
rebirth	rebirth
secondary	secondary
rts	rts
learn	learn
seattle	seattle
accounts	accounts
outer	outer
ordinary	ordinary
berry	berry
kaiser	kaiser
partnership	partnership
ly	ly
expanded	expanded
often	often
cannot	cannot
bahn	bahn
ahmed	ahmed
continental	continental
_stripes_white	_stripes_white
tango	tango
pax	pax
breathe	breathe
daddy	daddy
elite	elite
vhf	vhf
transition	transition
oral	oral
anchor	anchor
bullets	bullets
fh	fh
comparative	comparative
monde	monde
elliott	elliott
ces	ces
chester	chester
lupus	lupus
insurance	insurance
closer	closer
mixing	mixing
dialog	dialog
colorado	colorado
supérieure	supérieure
dress	dress
lay	lay
wikidata	wikidata
johan	johan
milk	milk
grass	grass
sage	sage
uw	uw
zx	zx
thriller	thriller
vault	vault
crush	crush
nrg	nrg
petersburg	petersburg
ridge	ridge
steam	steam
mice	mice
barnes	barnes
cbt	cbt
rouge	rouge
labour	labour
rafael	rafael
photograph	photograph
pont	pont
basil	basil
oracle	oracle
ado	ado
understand	understand
alu	alu
clouds	clouds
å	å
burg	burg
performed	performed
lotte	lotte
pay	pay
pitch	pitch
q_i	q_i
daughter	daughter
grove	grove
solomon	solomon
nds	nds
sphere	sphere
odd	odd
bangkok	bangkok
eternity	eternity
bubble	bubble
vv	vv
institution	institution
equal	equal
invisible	invisible
biological	biological
prunus	prunus
bailey	bailey
webster	webster
smaller	smaller
cvn	cvn
lz	lz
byte	byte
aires	aires
alpine	alpine
cooperation	cooperation
uni	uni
atlanta	atlanta
uml	uml
poetry	poetry
leipzig	leipzig
patent	patent
doctrine	doctrine
dialogue	dialogue
superstar	superstar
ant	ant
santos	santos
dana	dana
eia	eia
rocks	rocks
pow	pow
deutschen	deutschen
belong	belong
anders	anders
scream	scream
strip	strip
liar	liar
examples	examples
remixes	remixes
usgs	usgs
mirage	mirage
receptor	receptor
caroline	caroline
fishing	fishing
dbs	dbs
forbes	forbes
coding	coding
stuff	stuff
respect	respect
pandora	pandora
madame	madame
wehrmacht	wehrmacht
callicebus	callicebus
weapon	weapon
madison	madison
hcl	hcl
relative	relative
jungle	jungle
mov	mov
chess	chess
splash	splash
blake	blake
exploration	exploration
mann	mann
optional	optional
sabre	sabre
tile	tile
ash	ash
cable	cable
expert	expert
whatever	whatever
ww	ww
mori	mori
utility	utility
gulf	gulf
ini	ini
loud	loud
bravo	bravo
become	become
venezuela	venezuela
ciel	ciel
malta	malta
buenos	buenos
duc	duc
rec	rec
venice	venice
libertad	libertad
ntfs	ntfs
client	client
ems	ems
dragons	dragons
ivy	ivy
antoine	antoine
waves	waves
valentine	valentine
homme	homme
taste	taste
cum	cum
fcw	fcw
industries	industries
amendment	amendment
writings	writings
interpretation	interpretation
bdsm	bdsm
starlight	starlight
resurrection	resurrection
nas	nas
consciousness	consciousness
nightmare	nightmare
colombia	colombia
patrol	patrol
dolphin	dolphin
radical	radical
lesson	lesson
inf	inf
suzuki	suzuki
nominated	nominated
nuvola	nuvola
wie	wie
dollar	dollar
honour	honour
sale	sale
spectrum	spectrum
thee	thee
planetary	planetary
unlimited	unlimited
torres	torres
balance	balance
developers	developers
connor	connor
bleach	bleach
owen	owen
statistical	statistical
ox	ox
knock	knock
gonzález	gonzález
monsters	monsters
c_n	c_n
dat	dat
missouri	missouri
ky	ky
transmission	transmission
mill	mill
inline	inline
decade	decade
spice	spice
mccarthy	mccarthy
sessions	sessions
hub	hub
originally	originally
functional	functional
dsm	dsm
integral	integral
erich	erich
activities	activities
generations	generations
frontier	frontier
collections	collections
zr	zr
changed	changed
sales	sales
kin	kin
oak	oak
jsa	jsa
progressive	progressive
yy	yy
rugby	rugby
precious	precious
odyssey	odyssey
jw	jw
pope	pope
linked	linked
actress	actress
accident	accident
speaking	speaking
doesn	doesn
bwv	bwv
boo	boo
cubic	cubic
domestic	domestic
bed	bed
bitter	bitter
kay	kay
freeman	freeman
fo	fo
quarter	quarter
estadio	estadio
о	о
closed	closed
philosophie	philosophie
klein	klein
fas	fas
arabia	arabia
disorder	disorder
marquis	marquis
sections	sections
feedback	feedback
newspaper	newspaper
umts	umts
wav	wav
º	º
isn	isn
phillip	phillip
pon	pon
governor	governor
assault	assault
waltz	waltz
caesar	caesar
sophie	sophie
instrument	instrument
reflection	reflection
cult	cult
rat	rat
invalid	invalid
hungarian	hungarian
swedish	swedish
lima	lima
minimum	minimum
wet	wet
wise	wise
marshal	marshal
г	г
curve	curve
estate	estate
josh	josh
fallen	fallen
til	til
noah	noah
pizza	pizza
turkish	turkish
dies	dies
tutorial	tutorial
bosnia	bosnia
mali	mali
dale	dale
prelude	prelude
sis	sis
franco	franco
blow	blow
powered	powered
orion	orion
topic	topic
violin	violin
doom	doom
macaca	macaca
tempo	tempo
bits	bits
einstein	einstein
stellar	stellar
giuseppe	giuseppe
separate	separate
prototype	prototype
directly	directly
import	import
cie	cie
animated	animated
equilibrium	equilibrium
gis	gis
doing	doing
pepper	pepper
judge	judge
hana	hana
betty	betty
americans	americans
contribution	contribution
gal	gal
enhanced	enhanced
crj	crj
flac	flac
egyptian	egyptian
vintage	vintage
lieutenant	lieutenant
views	views
nes	nes
sud	sud
erp	erp
brasil	brasil
alright	alright
associates	associates
castro	castro
arabic	arabic
noel	noel
communist	communist
luc	luc
gpp	gpp
theodor	theodor
chinensis	chinensis
wolfram	wolfram
nero	nero
combination	combination
someday	someday
everlasting	everlasting
evaluation	evaluation
pod	pod
augustus	augustus
westminster	westminster
porte	porte
comments	comments
vega	vega
usc	usc
airborne	airborne
lccn	lccn
dwarf	dwarf
techniques	techniques
tags	tags
segment	segment
simulation	simulation
australis	australis
rebellion	rebellion
paradox	paradox
pound	pound
embedded	embedded
ada	ada
minnesota	minnesota
ruth	ruth
delivery	delivery
stm	stm
ig	ig
useful	useful
tel	tel
abba	abba
creator	creator
simply	simply
≥	≥
sorrow	sorrow
e_n	e_n
broadcast	broadcast
captcha	captcha
rather	rather
estonia	estonia
dreaming	dreaming
nist	nist
multimedia	multimedia
punch	punch
montgomery	montgomery
graph	graph
patterns	patterns
peach	peach
relation	relation
uno	uno
pulse	pulse
commonwealth	commonwealth
mapping	mapping
hex	hex
twelve	twelve
alain	alain
imax	imax
msc	msc
strawberry	strawberry
menu	menu
oops	oops
unity	unity
increment	increment
snake	snake
cruise	cruise
vols	vols
unsigned	unsigned
springs	springs
ottoman	ottoman
oregon	oregon
init	init
flavius	flavius
revolutionary	revolutionary
towards	towards
variant	variant
procedure	procedure
rivers	rivers
nuevo	nuevo
americana	americana
memoirs	memoirs
cio	cio
weber	weber
translations	translations
included	included
melbourne	melbourne
petit	petit
sets	sets
annotated	annotated
debut	debut
dreamer	dreamer
density	density
leaves	leaves
aau	aau
sick	sick
destruction	destruction
representation	representation
indoor	indoor
violence	violence
survival	survival
nielsen	nielsen
namco	namco
tunes	tunes
carey	carey
essential	essential
lisp	lisp
abe	abe
arizona	arizona
jeanne	jeanne
explosion	explosion
pony	pony
comment	comment
faust	faust
macedonia	macedonia
jake	jake
helena	helena
identifier	identifier
organ	organ
aspect	aspect
lib	lib
loved	loved
ecuador	ecuador
brooklyn	brooklyn
though	though
uci	uci
saturn	saturn
liberté	liberté
rodríguez	rodríguez
recognition	recognition
hardcore	hardcore
pistol	pistol
miami	miami
mohamed	mohamed
coverage	coverage
ams	ams
blossom	blossom
luxembourg	luxembourg
breath	breath
transfermarkt	transfermarkt
decimal	decimal
rabbit	rabbit
alma	alma
xt	xt
weekend	weekend
mao	mao
algorithms	algorithms
innocent	innocent
brent	brent
brotherhood	brotherhood
flags	flags
average	average
claire	claire
sega	sega
orthodox	orthodox
mouth	mouth
montreal	montreal
mechanism	mechanism
seventeen	seventeen
samurai	samurai
bond	bond
remote	remote
released	released
vom	vom
became	became
jenkins	jenkins
dieu	dieu
merge	merge
situation	situation
warsaw	warsaw
rodriguez	rodriguez
vogue	vogue
degrees	degrees
russo	russo
stranger	stranger
hyde	hyde
electro	electro
thai	thai
mina	mina
ribbon	ribbon
fowler	fowler
commentary	commentary
fiber	fiber
guest	guest
expansion	expansion
muhammad	muhammad
fref	fref
tactical	tactical
jacobs	jacobs
pioneer	pioneer
pearson	pearson
simbad	simbad
lightgrey	lightgrey
jar	jar
listed	listed
jerome	jerome
hdl	hdl
festa	festa
variety	variety
sco	sco
stones	stones
oriented	oriented
köln	köln
probably	probably
strength	strength
notable	notable
secrets	secrets
museo	museo
fusion	fusion
pvp	pvp
cabinet	cabinet
georgian	georgian
areas	areas
scarlet	scarlet
dorothy	dorothy
remixed	remixed
pietro	pietro
encyclopædia	encyclopædia
mills	mills
kfz	kfz
prison	prison
ami	ami
ocinsoutput	ocinsoutput
tin	tin
giants	giants
finger	finger
evolutionary	evolutionary
btr	btr
sant	sant
darwin	darwin
walls	walls
started	started
csv	csv
deutsch	deutsch
lightweight	lightweight
armor	armor
ferry	ferry
audi	audi
saunders	saunders
deus	deus
xyz	xyz
login	login
knights	knights
rcs	rcs
christina	christina
ceiling	ceiling
trading	trading
avant	avant
seine	seine
essence	essence
katherine	katherine
opinion	opinion
relationship	relationship
brett	brett
corner	corner
pérez	pérez
jamie	jamie
uniform	uniform
gaba	gaba
galileo	galileo
scar	scar
prologue	prologue
dedicated	dedicated
kz	kz
vk	vk
h_pattern_b	h_pattern_b
modified	modified
southeast	southeast
itself	itself
dms	dms
lift	lift
vl	vl
cites	cites
smg	smg
slash	slash
sonata	sonata
msi	msi
brooks	brooks
anc	anc
amber	amber
ala	ala
nan	nan
stella	stella
olive	olive
hosted	hosted
ends	ends
florence	florence
smoke	smoke
grupo	grupo
unplugged	unplugged
systematic	systematic
markup	markup
fdp	fdp
polar	polar
choose	choose
gerhard	gerhard
instruments	instruments
composer	composer
squadron	squadron
bicycle	bicycle
arcade	arcade
moves	moves
banana	banana
batman	batman
amanda	amanda
peoples	peoples
anatomy	anatomy
porter	porter
kev	kev
requirements	requirements
vacation	vacation
nakamura	nakamura
clara	clara
proper	proper
volumes	volumes
sketch	sketch
quarterly	quarterly
madonna	madonna
influence	influence
comme	comme
rue	rue
scientists	scientists
illustration	illustration
som	som
naacp	naacp
celebration	celebration
correct	correct
shah	shah
sinensis	sinensis
lunar	lunar
troops	troops
aqua	aqua
supply	supply
javascript	javascript
seek	seek
xxi	xxi
sally	sally
cinderella	cinderella
sens	sens
tick	tick
leopard	leopard
mint	mint
winston	winston
allowed	allowed
cmd	cmd
jvc	jvc
reset	reset
zfc	zfc
abdul	abdul
julio	julio
ida	ida
affair	affair
cvs	cvs
islam	islam
provide	provide
iceland	iceland
adaptation	adaptation
slim	slim
landmark	landmark
pascal	pascal
chandler	chandler
dominique	dominique
oklahoma	oklahoma
ipcc	ipcc
stress	stress
clay	clay
santo	santo
likely	likely
baden	baden
chapel	chapel
nostalgia	nostalgia
pursuit	pursuit
guys	guys
coin	coin
clayton	clayton
ecology	ecology
fix	fix
rebecca	rebecca
gerard	gerard
boris	boris
console	console
anthology	anthology
gotta	gotta
rainy	rainy
lorenzo	lorenzo
lions	lions
mel	mel
lemon	lemon
glossary	glossary
knew	knew
longer	longer
ham	ham
stein	stein
zn	zn
composite	composite
acre	acre
joachim	joachim
sana	sana
damage	damage
tiff	tiff
ukrainian	ukrainian
bacon	bacon
talking	talking
hara	hara
ipad	ipad
nom	nom
maryland	maryland
oa	oa
steps	steps
mickey	mickey
nasl	nasl
conan	conan
ericsson	ericsson
yemen	yemen
dolls	dolls
students	students
peninsula	peninsula
employee	employee
spirits	spirits
opus	opus
hung	hung
alejandro	alejandro
prior	prior
modules	modules
civilization	civilization
a_pattern_b	a_pattern_b
scholar	scholar
stg	stg
smithsonian	smithsonian
edmund	edmund
crm	crm
printing	printing
alexandra	alexandra
burton	burton
bloom	bloom
chaser	chaser
mms	mms
raven	raven
rico	rico
blackwell	blackwell
elephant	elephant
acp	acp
sola	sola
cliff	cliff
blg	blg
deck	deck
bowl	bowl
panel	panel
fool	fool
concepts	concepts
items	items
mio	mio
prometheus	prometheus
wat	wat
loading	loading
wrc	wrc
kuwait	kuwait
andante	andante
geforce	geforce
layout	layout
criminal	criminal
glen	glen
tie	tie
coup	coup
lands	lands
danger	danger
dn	dn
workshop	workshop
mart	mart
mystic	mystic
dub	dub
archived	archived
alessandro	alessandro
ew	ew
mae	mae
received	received
duty	duty
arranged	arranged
netbsd	netbsd
principal	principal
replay	replay
organisation	organisation
challenger	challenger
bdfutbol	bdfutbol
runner	runner
neon	neon
lithuania	lithuania
buy	buy
webb	webb
messenger	messenger
gould	gould
jews	jews
settlement	settlement
sit	sit
versus	versus
teddy	teddy
cfr	cfr
begins	begins
piazza	piazza
lauren	lauren
geometry	geometry
vermont	vermont
narcissus	narcissus
_n	_n
savage	savage
bach	bach
jules	jules
intelligent	intelligent
digit	digit
equivalent	equivalent
seminary	seminary
shared	shared
adagio	adagio
reconstruction	reconstruction
wmf	wmf
survivor	survivor
fraser	fraser
buzz	buzz
cao	cao
gain	gain
actually	actually
wikiproject	wikiproject
panther	panther
s_n	s_n
reach	reach
ot	ot
deluxe	deluxe
xn	xn
u_i	u_i
rk	rk
mechanical	mechanical
neutral	neutral
lucia	lucia
madagascar	madagascar
battlefield	battlefield
delle	delle
concat	concat
dover	dover
niger	niger
capacity	capacity
tate	tate
bean	bean
mack	mack
wgs	wgs
dallas	dallas
arh	arh
binding	binding
leonardo	leonardo
dino	dino
helicopter	helicopter
clover	clover
clube	clube
bells	bells
judith	judith
sent	sent
calcio	calcio
burns	burns
metadata	metadata
libre	libre
variations	variations
jewel	jewel
sue	sue
variables	variables
mvs	mvs
milton	milton
gateway	gateway
deutsches	deutsches
h_body	h_body
elder	elder
daisy	daisy
é	é
salon	salon
formats	formats
ethics	ethics
fellowship	fellowship
relationships	relationships
annie	annie
comet	comet
voip	voip
flex	flex
titan	titan
broadway	broadway
settings	settings
heinz	heinz
mari	mari
crs	crs
dogg	dogg
marx	marx
leisure	leisure
firefox	firefox
bounce	bounce
gem	gem
c_i	c_i
measure	measure
gardens	gardens
mcdonald	mcdonald
canton	canton
monroe	monroe
gta	gta
samoa	samoa
suicide	suicide
ige	ige
stuttgart	stuttgart
orlando	orlando
manufacturing	manufacturing
boolean	boolean
battles	battles
crimea	crimea
enterprises	enterprises
tang	tang
dtd	dtd
eda	eda
tax	tax
carnegie	carnegie
wisconsin	wisconsin
gts	gts
replacement	replacement
spiritual	spiritual
essex	essex
census	census
leg	leg
od	od
mosaic	mosaic
hotcat	hotcat
rj	rj
mongolia	mongolia
buck	buck
agricultural	agricultural
reynolds	reynolds
negro	negro
detroit	detroit
alternate	alternate
chronicles	chronicles
jquery	jquery
jong	jong
violet	violet
shoulder	shoulder
cache	cache
magna	magna
shtml	shtml
concerning	concerning
conway	conway
vic	vic
nina	nina
superman	superman
classes	classes
territorial	territorial
pad	pad
spark	spark
surprise	surprise
herald	herald
usage	usage
messier	messier
jenny	jenny
separation	separation
_adidaswhite	_adidaswhite
haiti	haiti
wikisource	wikisource
declaration	declaration
greenwood	greenwood
wir	wir
sanders	sanders
tls	tls
mic	mic
morrison	morrison
addition	addition
cosmos	cosmos
garrett	garrett
sram	sram
ussr	ussr
к	к
overture	overture
crawford	crawford
pierce	pierce
rep	rep
heard	heard
enrique	enrique
у	у
ry	ry
nadh	nadh
trace	trace
proud	proud
protect	protect
orientalis	orientalis
felis	felis
panda	panda
ursus	ursus
troy	troy
date_string	date_string
albania	albania
toc	toc
femme	femme
blast	blast
killed	killed
ugly	ugly
somewhere	somewhere
burst	burst
gross	gross
associate	associate
funny	funny
telegraph	telegraph
cartoon	cartoon
struggle	struggle
willie	willie
bangladesh	bangladesh
richmond	richmond
empress	empress
tcl	tcl
cno	cno
pueblo	pueblo
fake	fake
shannon	shannon
discography	discography
chrome	chrome
flood	flood
rft	rft
ipod	ipod
pipe	pipe
universidad	universidad
tiny	tiny
hundred	hundred
geography	geography
gutenberg	gutenberg
h_shorts	h_shorts
necessary	necessary
_k	_k
alexandre	alexandre
pleasure	pleasure
ser	ser
gentleman	gentleman
cli	cli
towers	towers
rei	rei
visions	visions
sight	sight
generator	generator
fig	fig
moe	moe
honorary	honorary
exist	exist
winners	winners
austrian	austrian
shown	shown
creating	creating
psychological	psychological
coli	coli
footballdatabase	footballdatabase
dying	dying
bmx	bmx
bottle	bottle
liverpool	liverpool
containing	containing
evo	evo
finite	finite
designer	designer
magnus	magnus
cars	cars
disaster	disaster
libraries	libraries
triumph	triumph
magical	magical
misty	misty
philharmonic	philharmonic
nucleus	nucleus
moral	moral
aspects	aspects
slip	slip
forgotten	forgotten
visible	visible
raise	raise
regina	regina
corvus	corvus
structural	structural
titles	titles
kissing	kissing
concern	concern
thus	thus
collision	collision
thirty	thirty
bella	bella
monica	monica
ahead	ahead
mhc	mhc
stan	stan
achievement	achievement
buildings	buildings
periodical	periodical
gcd	gcd
uncle	uncle
kyle	kyle
stadt	stadt
bmc	bmc
sarajevo	sarajevo
autonomous	autonomous
rough	rough
usually	usually
columns	columns
tragedy	tragedy
smooth	smooth
vmware	vmware
orient	orient
palais	palais
noaa	noaa
luther	luther
transaction	transaction
practical	practical
editions	editions
ej	ej
r_i	r_i
igor	igor
sultan	sultan
thin	thin
genetics	genetics
yr	yr
cards	cards
carroll	carroll
personality	personality
feed	feed
lam	lam
persian	persian
ara	ara
partido	partido
monastery	monastery
rover	rover
manuscript	manuscript
و	و
paraguay	paraguay
limits	limits
veronica	veronica
biographical	biographical
deletion	deletion
notation	notation
vw	vw
belt	belt
iis	iis
ode	ode
telecom	telecom
infrastructure	infrastructure
coalition	coalition
sofia	sofia
repository	repository
crossover	crossover
barset	barset
leaders	leaders
cookie	cookie
hail	hail
tear	tear
invitation	invitation
hear	hear
volcano	volcano
ψ	ψ
maxwell	maxwell
andrews	andrews
cambodia	cambodia
konrad	konrad
kunst	kunst
abl	abl
coco	coco
indica	indica
shut	shut
sharon	sharon
uzi	uzi
marriage	marriage
amen	amen
dam	dam
_i	_i
administrator	administrator
eyed	eyed
roth	roth
sergio	sergio
thor	thor
northwest	northwest
prentice	prentice
cue	cue
tracking	tracking
legislative	legislative
ulrich	ulrich
joey	joey
plasma	plasma
tout	tout
rhine	rhine
neue	neue
fed	fed
knox	knox
berg	berg
compiler	compiler
waters	waters
pira	pira
fender	fender
greco	greco
portuguese	portuguese
linguistics	linguistics
although	although
abdullah	abdullah
français	français
tdi	tdi
χ	χ
mental	mental
mysteries	mysteries
income	income
cheese	cheese
baptiste	baptiste
emil	emil
wap	wap
lars	lars
attribute	attribute
bound	bound
crimson	crimson
cognitive	cognitive
pull	pull
poison	poison
gustave	gustave
alfonso	alfonso
lance	lance
dubai	dubai
regiment	regiment
warszawa	warszawa
plot	plot
debate	debate
reload	reload
parties	parties
gardner	gardner
mitsubishi	mitsubishi
hardy	hardy
cfl	cfl
vanessa	vanessa
ming	ming
saguinus	saguinus
mutual	mutual
bike	bike
phys	phys
sporting	sporting
proto	proto
aura	aura
giving	giving
downtown	downtown
terre	terre
wma	wma
levi	levi
incorporated	incorporated
assisted	assisted
dig	dig
neural	neural
schuster	schuster
proposal	proposal
customer	customer
serious	serious
elegans	elegans
louisiana	louisiana
mim	mim
burke	burke
exodus	exodus
wei	wei
ass	ass
gothic	gothic
gives	gives
pray	pray
buffer	buffer
sanctuary	sanctuary
wins	wins
cgs	cgs
rebel	rebel
calls	calls
cnt	cnt
infrared	infrared
_color_	_color_
twa	twa
blair	blair
healing	healing
tata	tata
csa	csa
xfce	xfce
ballistic	ballistic
cooking	cooking
shawn	shawn
indo	indo
guided	guided
ub	ub
colonel	colonel
actual	actual
composition	composition
latex	latex
wiz	wiz
activex	activex
viktor	viktor
farewell	farewell
conversion	conversion
rings	rings
imagine	imagine
allison	allison
massive	massive
robots	robots
yoshi	yoshi
mein	mein
steady	steady
wants	wants
césar	césar
oxide	oxide
writers	writers
rey	rey
collar	collar
failed	failed
istanbul	istanbul
robertson	robertson
greene	greene
interaction	interaction
toxic	toxic
lopez	lopez
johnston	johnston
pavilion	pavilion
registry	registry
tourist	tourist
prof	prof
tmp	tmp
companies	companies
fernández	fernández
martha	martha
babylon	babylon
carcharhinus	carcharhinus
pegi	pegi
cleveland	cleveland
joão	joão
percy	percy
shadows	shadows
checkuser	checkuser
fluid	fluid
handler	handler
dramatic	dramatic
signs	signs
perform	perform
americas	americas
manga	manga
excellent	excellent
contain	contain
variation	variation
civic	civic
mono	mono
currently	currently
queens	queens
apa	apa
rand	rand
henderson	henderson
programs	programs
vg	vg
conrad	conrad
jas	jas
sgt	sgt
norwegian	norwegian
danish	danish
tao	tao
puma	puma
owl	owl
visa	visa
nvidia	nvidia
б	б
fail	fail
fountain	fountain
machines	machines
genome	genome
reflections	reflections
café	café
founder	founder
bridges	bridges
symbols	symbols
ran	ran
boi	boi
basel	basel
casa	casa
send	send
amateur	amateur
except	except
guidance	guidance
claw	claw
sirius	sirius
annals	annals
leopold	leopold
wade	wade
italic	italic
nazi	nazi
truck	truck
donna	donna
workers	workers
figures	figures
spread	spread
anyone	anyone
jensen	jensen
è	è
het	het
slide	slide
winds	winds
agriculture	agriculture
dai	dai
hrsg	hrsg
meat	meat
uz	uz
k_b	k_b
aces	aces
csc	csc
rays	rays
dependent	dependent
adc	adc
nicht	nicht
npr	npr
doe	doe
extensive	extensive
shrine	shrine
primo	primo
isla	isla
explanation	explanation
omar	omar
fault	fault
claudia	claudia
awakening	awakening
orbital	orbital
ferguson	ferguson
stern	stern
gz	gz
ricardo	ricardo
transform	transform
porto	porto
butter	butter
muzik	muzik
cosmo	cosmo
a_body	a_body
ek	ek
organic	organic
rattus	rattus
malcolm	malcolm
okay	okay
rufus	rufus
spears	spears
cardinal	cardinal
fatal	fatal
ono	ono
a_shorts	a_shorts
substitute	substitute
told	told
unified	unified
symposium	symposium
méxico	méxico
passive	passive
myspace	myspace
fans	fans
hash	hash
telephone	telephone
utah	utah
bristol	bristol
detection	detection
prevention	prevention
churches	churches
richards	richards
cics	cics
motors	motors
avoid	avoid
partner	partner
fiesta	fiesta
probability	probability
neal	neal
paperback	paperback
musique	musique
shore	shore
exercise	exercise
founded	founded
airplay	airplay
remains	remains
quebec	quebec
changing	changing
ze	ze
nomenclature	nomenclature
permanent	permanent
consortium	consortium
practices	practices
sylvia	sylvia
bei	bei
monarchy	monarchy
mundo	mundo
breakdown	breakdown
commit	commit
pgm	pgm
soi	soi
pig	pig
kenya	kenya
intellectual	intellectual
voltage	voltage
bom	bom
herpestes	herpestes
billie	billie
bytes	bytes
intermediate	intermediate
rocky	rocky
sociology	sociology
bios	bios
dia	dia
electrical	electrical
rhodes	rhodes
pace	pace
valenti	valenti
oro	oro
forte	forte
removed	removed
deputy	deputy
gimme	gimme
performing	performing
bonaparte	bonaparte
bolivia	bolivia
csu	csu
toward	toward
visiting	visiting
ideal	ideal
bayern	bayern
kyoto	kyoto
boots	boots
scan	scan
fes	fes
synthesis	synthesis
rally	rally
speedy	speedy
twist	twist
reform	reform
davies	davies
died	died
poem	poem
cow	cow
gracilis	gracilis
riley	riley
stereo	stereo
stardust	stardust
jcb	jcb
previous	previous
battery	battery
unep	unep
obituary	obituary
tba	tba
vorbis	vorbis
marching	marching
hansen	hansen
willem	willem
tours	tours
afl	afl
msnbc	msnbc
illegal	illegal
clinical	clinical
diesel	diesel
controller	controller
deux	deux
emission	emission
hull	hull
outline	outline
extensions	extensions
rhapsody	rhapsody
diane	diane
expedition	expedition
scientist	scientist
guild	guild
idc	idc
legion	legion
queensland	queensland
dic	dic
strand	strand
bugs	bugs
worst	worst
drake	drake
pca	pca
jackie	jackie
boyd	boyd
delight	delight
emirates	emirates
lópez	lópez
usaf	usaf
zeppelin	zeppelin
carmen	carmen
registration	registration
patterson	patterson
palmer	palmer
mesh	mesh
nand	nand
janet	janet
brick	brick
avec	avec
coleman	coleman
roi	roi
separated	separated
republican	republican
interchange	interchange
proposed	proposed
lamb	lamb
calcium	calcium
naxos	naxos
drugs	drugs
carpenter	carpenter
thermal	thermal
ifa	ifa
nexus	nexus
trna	trna
dsl	dsl
mis	mis
elliot	elliot
continue	continue
©	©
maximus	maximus
himself	himself
adhd	adhd
heather	heather
horace	horace
cologne	cologne
mare	mare
thesis	thesis
arrangement	arrangement
eads	eads
wendy	wendy
prussia	prussia
reuters	reuters
wwdc	wwdc
dal	dal
nicola	nicola
wh	wh
observer	observer
stronger	stronger
linguistic	linguistic
dispute	dispute
bun	bun
newman	newman
ren	ren
cemetery	cemetery
ivb	ivb
charter	charter
chronology	chronology
jigsaw	jigsaw
palazzo	palazzo
musik	musik
basis	basis
warriors	warriors
cuisine	cuisine
iowa	iowa
ochotona	ochotona
ski	ski
processes	processes
orleans	orleans
largest	largest
bos	bos
dhc	dhc
awake	awake
particles	particles
elo	elo
responsibility	responsibility
е	е
especially	especially
bitch	bitch
fortran	fortran
fuji	fuji
impossible	impossible
engines	engines
significant	significant
protected	protected
continuous	continuous
emmanuel	emmanuel
upload	upload
jade	jade
umbrella	umbrella
boogie	boogie
worship	worship
fac	fac
willy	willy
ifpi	ifpi
brought	brought
drag	drag
deutscher	deutscher
dissertation	dissertation
losing	losing
appeal	appeal
knife	knife
vampire	vampire
christoph	christoph
rica	rica
cotton	cotton
regulation	regulation
boundary	boundary
s_i	s_i
advisory	advisory
turing	turing
a_pattern_s	a_pattern_s
scenes	scenes
dylan	dylan
gym	gym
clinton	clinton
autobiography	autobiography
buddy	buddy
providence	providence
wmflabs	wmflabs
h_pattern_s	h_pattern_s
tca	tca
parks	parks
editorial	editorial
e_i	e_i
einer	einer
swim	swim
rivera	rivera
artillery	artillery
typhoon	typhoon
transcript	transcript
natalie	natalie
hui	hui
mii	mii
anonymous	anonymous
scratch	scratch
didn	didn
archer	archer
wmv	wmv
demon	demon
moses	moses
souls	souls
copa	copa
modeling	modeling
mohammed	mohammed
aerospace	aerospace
zombie	zombie
sncf	sncf
lounge	lounge
alexandria	alexandria
joyce	joyce
genetta	genetta
vinyl	vinyl
falcon	falcon
derby	derby
serve	serve
wt	wt
maple	maple
guidelines	guidelines
serif	serif
unhcr	unhcr
balls	balls
caribbean	caribbean
holt	holt
ue	ue
rows	rows
matching	matching
saxony	saxony
v_i	v_i
wonders	wonders
json	json
michele	michele
garde	garde
metropolis	metropolis
tests	tests
bodies	bodies
lateral	lateral
lesser	lesser
graf	graf
worth	worth
resonance	resonance
fib	fib
exclusive	exclusive
igg	igg
ntsb	ntsb
stephanie	stephanie
ceremony	ceremony
juniperus	juniperus
repeat	repeat
fathers	fathers
hippocampus	hippocampus
previously	previously
churchill	churchill
wired	wired
kepler	kepler
eulemur	eulemur
panama	panama
ses	ses
lectures	lectures
cod	cod
alphabet	alphabet
heights	heights
passage	passage
maison	maison
n_i	n_i
percent	percent
perspectives	perspectives
highest	highest
merchant	merchant
attribution	attribution
lantern	lantern
marlborough	marlborough
gave	gave
lac	lac
crane	crane
rsi	rsi
leben	leben
helmut	helmut
archaeology	archaeology
¼	¼
gpa	gpa
whois	whois
lovin	lovin
kingston	kingston
firm	firm
mers	mers
esc	esc
nlp	nlp
boxes	boxes
fundamental	fundamental
gv	gv
irving	irving
casey	casey
planck	planck
ramón	ramón
wpa	wpa
nadph	nadph
adelaide	adelaide
x_k	x_k
password	password
gottfried	gottfried
shoes	shoes
algeria	algeria
ó	ó
fredrik	fredrik
laurence	laurence
shuttle	shuttle
saving	saving
morocco	morocco
viking	viking
lips	lips
ifk	ifk
sterling	sterling
ytv	ytv
src	src
belarus	belarus
roosevelt	roosevelt
residence	residence
conditions	conditions
diamonds	diamonds
reid	reid
roof	roof
positions	positions
twins	twins
burma	burma
narrative	narrative
solutions	solutions
ping	ping
differential	differential
pvc	pvc
curse	curse
dancer	dancer
certificate	certificate
freak	freak
viewer	viewer
grammy	grammy
successful	successful
lorraine	lorraine
emp	emp
schwarz	schwarz
xu	xu
iww	iww
dbe	dbe
aquatic	aquatic
soil	soil
quit	quit
wagon	wagon
played	played
governance	governance
shoot	shoot
lap	lap
incident	incident
vera	vera
mtu	mtu
ö	ö
chat	chat
observations	observations
baa	baa
stick	stick
eagles	eagles
setting	setting
thames	thames
yard	yard
rrna	rrna
rdf	rdf
bath	bath
ritter	ritter
xviii	xviii
labs	labs
pluto	pluto
reilly	reilly
torpedo	torpedo
oxygen	oxygen
particular	particular
glam	glam
codex	codex
barrett	barrett
fury	fury
hpv	hpv
improved	improved
apart	apart
randall	randall
ghana	ghana
fai	fai
basilica	basilica
anas	anas
christie	christie
н	н
neville	neville
effective	effective
auguste	auguste
communities	communities
rodney	rodney
sherman	sherman
lambert	lambert
packet	packet
sector	sector
propaganda	propaganda
collective	collective
noir	noir
breed	breed
shit	shit
nest	nest
minus	minus
excellence	excellence
finding	finding
voyager	voyager
horror	horror
pops	pops
alo	alo
gilles	gilles
botanical	botanical
nebraska	nebraska
instituto	instituto
facilities	facilities
parish	parish
göttingen	göttingen
grub	grub
centro	centro
becker	becker
bride	bride
cornelius	cornelius
idf	idf
wiener	wiener
storia	storia
smash	smash
fully	fully
ethiopia	ethiopia
dakota	dakota
vivo	vivo
savoy	savoy
benson	benson
vatican	vatican
motorola	motorola
rita	rita
davidson	davidson
richter	richter
indians	indians
went	went
ldl	ldl
kosovo	kosovo
quincy	quincy
username	username
kitchen	kitchen
automatically	automatically
cincinnati	cincinnati
frances	frances
ability	ability
porsche	porsche
marino	marino
qi	qi
pirates	pirates
nlm	nlm
nic	nic
b_i	b_i
sherlock	sherlock
allow	allow
prague	prague
incredible	incredible
currency	currency
craft	craft
zen	zen
humanities	humanities
abuse	abuse
velocity	velocity
voting	voting
mermaid	mermaid
warm	warm
brew	brew
ama	ama
syfy	syfy
larger	larger
injection	injection
torre	torre
carson	carson
worm	worm
kirk	kirk
sidney	sidney
verse	verse
judy	judy
jamaica	jamaica
textcolor	textcolor
soup	soup
vehicles	vehicles
cnc	cnc
wikipedias	wikipedias
champ	champ
htv	htv
trigger	trigger
houses	houses
factors	factors
axel	axel
mayer	mayer
erwin	erwin
leone	leone
trevor	trevor
alfredo	alfredo
clarence	clarence
walsh	walsh
cmmi	cmmi
relevant	relevant
flores	flores
toi	toi
rae	rae
moa	moa
yours	yours
doo	doo
soho	soho
travis	travis
marvin	marvin
heartbreaker	heartbreaker
como	como
tuesday	tuesday
cyrus	cyrus
martes	martes
moi	moi
bnp	bnp
panthera	panthera
pam	pam
muse	muse
baldwin	baldwin
computational	computational
mei	mei
martínez	martínez
manning	manning
mississippi	mississippi
jvm	jvm
nara	nara
ethnic	ethnic
atlantis	atlantis
rl	rl
pri	pri
helix	helix
hale	hale
elisabeth	elisabeth
collapsible	collapsible
bourne	bourne
vba	vba
lamp	lamp
bucharest	bucharest
offensive	offensive
genie	genie
boats	boats
zoology	zoology
melissa	melissa
mathematica	mathematica
copper	copper
aurora	aurora
regarding	regarding
appears	appears
partei	partei
antarctica	antarctica
piper	piper
newsletter	newsletter
expected	expected
comp	comp
shirt	shirt
lenin	lenin
vf	vf
hw	hw
bavaria	bavaria
prima	prima
friedman	friedman
faces	faces
riot	riot
avalon	avalon
supporting	supporting
styles	styles
madness	madness
hay	hay
socialism	socialism
sourceforge	sourceforge
turning	turning
sod	sod
anglo	anglo
jelly	jelly
quinn	quinn
cricket	cricket
xr	xr
wifi	wifi
paint	paint
distinguished	distinguished
enabled	enabled
vis	vis
awb	awb
cds	cds
fill	fill
levy	levy
imp	imp
endangered	endangered
clarendon	clarendon
zambia	zambia
pigeon	pigeon
mosque	mosque
lat	lat
listing	listing
hydrogen	hydrogen
marry	marry
guerra	guerra
société	société
ofk	ofk
lex	lex
hanging	hanging
welt	welt
pixel	pixel
probe	probe
causes	causes
pq	pq
cooperative	cooperative
entre	entre
mozart	mozart
waffen	waffen
ferrari	ferrari
borough	borough
lai	lai
sánchez	sánchez
ecb	ecb
monobook	monobook
indigo	indigo
fog	fog
hiroshima	hiroshima
formal	formal
parc	parc
appropriate	appropriate
reprint	reprint
plymouth	plymouth
nach	nach
asus	asus
ids	ids
btu	btu
imagination	imagination
placed	placed
gtb	gtb
fleur	fleur
unofficial	unofficial
clown	clown
rotation	rotation
canadensis	canadensis
deer	deer
spp	spp
capitol	capitol
keller	keller
quartet	quartet
eff	eff
indicator	indicator
adb	adb
celtic	celtic
heath	heath
halloween	halloween
flagge	flagge
herzegovina	herzegovina
blanc	blanc
t_n	t_n
acb	acb
pays	pays
leap	leap
sous	sous
singing	singing
lip	lip
sheep	sheep
beth	beth
transactions	transactions
harder	harder
pratt	pratt
fitzgerald	fitzgerald
arsenal	arsenal
blame	blame
matters	matters
peterson	peterson
judas	judas
computers	computers
sides	sides
cab	cab
mania	mania
jdam	jdam
república	república
mayor	mayor
hai	hai
dinosaur	dinosaur
oder	oder
atmosphere	atmosphere
macro	macro
liga	liga
readers	readers
drift	drift
presence	presence
ind	ind
eth	eth
sandy	sandy
fest	fest
m_i	m_i
byron	byron
frozen	frozen
milano	milano
reduction	reduction
reeves	reeves
lhc	lhc
satellites	satellites
constellation	constellation
hubert	hubert
provence	provence
tnf	tnf
capsule	capsule
riemann	riemann
bcg	bcg
université	université
friendly	friendly
gale	gale
fade	fade
jakob	jakob
developed	developed
bars	bars
herb	herb
circular	circular
uganda	uganda
irwin	irwin
consequences	consequences
wikimania	wikimania
lamborghini	lamborghini
technique	technique
mines	mines
wg	wg
fork	fork
kathleen	kathleen
rangers	rangers
dresden	dresden
memoir	memoir
bismarck	bismarck
leigh	leigh
bernd	bernd
massimo	massimo
pieter	pieter
tall	tall
esl	esl
mirotic	mirotic
ilo	ilo
chambers	chambers
validation	validation
citizen	citizen
analog	analog
fax	fax
abel	abel
adp	adp
departure	departure
trump	trump
emergence	emergence
hercules	hercules
witness	witness
sheets	sheets
norad	norad
gorilla	gorilla
vim	vim
_blackshoulders	_blackshoulders
randy	randy
vibe	vibe
toe	toe
proxy	proxy
marion	marion
cowboy	cowboy
semiconductor	semiconductor
algebra	algebra
lebanon	lebanon
lawson	lawson
dante	dante
rainer	rainer
agnes	agnes
brill	brill
athletic	athletic
yan	yan
meg	meg
optimization	optimization
beyoncé	beyoncé
citationclass	citationclass
mea	mea
haute	haute
brien	brien
guillaume	guillaume
jour	jour
cavalry	cavalry
berliner	berliner
diet	diet
chad	chad
planned	planned
concrete	concrete
steal	steal
cage	cage
sio	sio
spotted	spotted
courage	courage
wishes	wishes
federated	federated
crescent	crescent
shi	shi
bag	bag
whose	whose
seth	seth
punishment	punishment
ding	ding
jürgen	jürgen
anchor_year	anchor_year
weak	weak
logical	logical
cyprus	cyprus
wheeler	wheeler
drink	drink
sae	sae
btl	btl
kentucky	kentucky
loaded	loaded
turtle	turtle
nazionale	nazionale
facto	facto
dirk	dirk
uns	uns
sac	sac
foto	foto
qb	qb
flesh	flesh
covers	covers
deleted	deleted
stephan	stephan
coma	coma
steward	steward
tod	tod
obama	obama
cervus	cervus
riders	riders
encode	encode
membrane	membrane
bahrain	bahrain
nevada	nevada
scout	scout
contra	contra
osce	osce
confederation	confederation
tierra	tierra
untitled	untitled
monuments	monuments
bac	bac
mobility	mobility
baptist	baptist
desc	desc
armour	armour
hx	hx
degli	degli
imagesize	imagesize
trials	trials
grow	grow
mor	mor
hoc	hoc
gatt	gatt
capensis	capensis
jude	jude
breakfast	breakfast
sharing	sharing
luz	luz
lizard	lizard
stamp	stamp
sasha	sasha
gemini	gemini
alabama	alabama
tong	tong
elisa	elisa
nyse	nyse
mysterious	mysterious
marin	marin
tailed	tailed
teresa	teresa
knot	knot
varanus	varanus
handle	handle
gprs	gprs
shepherd	shepherd
lothar	lothar
brandenburg	brandenburg
criticism	criticism
superior	superior
portland	portland
neill	neill
existing	existing
coordinate	coordinate
clement	clement
shu	shu
arctic	arctic
confessions	confessions
revue	revue
singh	singh
swap	swap
smtp	smtp
traveler	traveler
spelling	spelling
calculus	calculus
apply	apply
timor	timor
celestial	celestial
ump	ump
sequences	sequences
elections	elections
ncis	ncis
norte	norte
svt	svt
stevenson	stevenson
heads	heads
delhi	delhi
lollipop	lollipop
musica	musica
runaway	runaway
plains	plains
facility	facility
authorlink	authorlink
jagger	jagger
poster	poster
fist	fist
critique	critique
bfff	bfff
immortal	immortal
petrus	petrus
hunting	hunting
cls	cls
darren	darren
ago	ago
xj	xj
revisited	revisited
trend	trend
nacl	nacl
koh	koh
shopping	shopping
celebrity	celebrity
antony	antony
ranger	ranger
hypothesis	hypothesis
colours	colours
feminist	feminist
montréal	montréal
forth	forth
benedict	benedict
dynamite	dynamite
simone	simone
cephalophus	cephalophus
centuries	centuries
leopardus	leopardus
revival	revival
gaius	gaius
altitude	altitude
qc	qc
münster	münster
t_i	t_i
encoding	encoding
molly	molly
afternoon	afternoon
gesellschaft	gesellschaft
podcast	podcast
namibia	namibia
regions	regions
stripped	stripped
doubleday	doubleday
bermuda	bermuda
lessons	lessons
beside	beside
symbolic	symbolic
girlfriend	girlfriend
pdb	pdb
seas	seas
alert	alert
philips	philips
myths	myths
،	،
nose	nose
trunk	trunk
erj	erj
bonn	bonn
hierarchy	hierarchy
sandwich	sandwich
collage	collage
doubt	doubt
extract	extract
kitty	kitty
cellular	cellular
networking	networking
alla	alla
chapman	chapman
faster	faster
gsp	gsp
teatro	teatro
bernhard	bernhard
tactics	tactics
terminology	terminology
campeonato	campeonato
nerve	nerve
capra	capra
surrender	surrender
moreno	moreno
eli	eli
loan	loan
bello	bello
quo	quo
zion	zion
parsons	parsons
launched	launched
weeks	weeks
acer	acer
reserved	reserved
createelement	createelement
moved	moved
looks	looks
discrete	discrete
monaco	monaco
plays	plays
restoration	restoration
bcs	bcs
jolly	jolly
harbour	harbour
xvi	xvi
heap	heap
nico	nico
tous	tous
connected	connected
lords	lords
eduard	eduard
exception	exception
damon	damon
reign	reign
provinces	provinces
utopia	utopia
tac	tac
blanco	blanco
nmr	nmr
architects	architects
shady	shady
sic	sic
cnet	cnet
couple	couple
induced	induced
stokes	stokes
bust	bust
meter	meter
criteria	criteria
mccartney	mccartney
lowe	lowe
gmp	gmp
nowhere	nowhere
improvement	improvement
liam	liam
presented	presented
revenue	revenue
skeleton	skeleton
driving	driving
convergence	convergence
sdtv	sdtv
intended	intended
extinction	extinction
zeit	zeit
lifetime	lifetime
postscript	postscript
openbsd	openbsd
execution	execution
orb	orb
pagan	pagan
enable	enable
holocaust	holocaust
comte	comte
angola	angola
jus	jus
leeds	leeds
houghton	houghton
speaker	speaker
citrus	citrus
instant	instant
behaviour	behaviour
mud	mud
atoll	atoll
xavier	xavier
simulator	simulator
rating	rating
perseus	perseus
connect	connect
syntax	syntax
directors	directors
boost	boost
dre	dre
established	established
_white	_white
everett	everett
reasons	reasons
ranks	ranks
holes	holes
began	began
paula	paula
ü	ü
alley	alley
barrel	barrel
milne	milne
heartbeat	heartbeat
butterflies	butterflies
muslim	muslim
iraqi	iraqi
zi	zi
foundations	foundations
lennon	lennon
talent	talent
meters	meters
requires	requires
kazakhstan	kazakhstan
cel	cel
breaker	breaker
issued	issued
opt	opt
papua	papua
tennessee	tennessee
amore	amore
demonstration	demonstration
bertrand	bertrand
reg	reg
leiden	leiden
alcohol	alcohol
fis	fis
vox	vox
irene	irene
geology	geology
études	études
brass	brass
д	д
karma	karma
memphis	memphis
operational	operational
arrival	arrival
perception	perception
adler	adler
armenian	armenian
bayer	bayer
hector	hector
kane	kane
mushroom	mushroom
barber	barber
profit	profit
liechtenstein	liechtenstein
siècle	siècle
juliet	juliet
nepal	nepal
translatewiki	translatewiki
liber	liber
mob	mob
races	races
brilliant	brilliant
lange	lange
versailles	versailles
waste	waste
bedford	bedford
dad	dad
eugène	eugène
compound	compound
decode	decode
lev	lev
ripper	ripper
masterpiece	masterpiece
israeli	israeli
critics	critics
nut	nut
loose	loose
enjoy	enjoy
assistance	assistance
soa	soa
ν	ν
cto	cto
dumb	dumb
walt	walt
christians	christians
offer	offer
iz	iz
renewal	renewal
cradle	cradle
tanzania	tanzania
preparation	preparation
brazilian	brazilian
gangsta	gangsta
canto	canto
williamson	williamson
acs	acs
stupid	stupid
nouvelle	nouvelle
ics	ics
clive	clive
mutant	mutant
consensus	consensus
individuals	individuals
felipe	felipe
olsen	olsen
longman	longman
topics	topics
owner	owner
tracy	tracy
twice	twice
nursing	nursing
leaving	leaving
roller	roller
oi	oi
alfa	alfa
amount	amount
lionel	lionel
sustainable	sustainable
oliveira	oliveira
bend	bend
quattro	quattro
serie	serie
dope	dope
transcription	transcription
zürich	zürich
praise	praise
util	util
forty	forty
alvin	alvin
tablet	tablet
param	param
sprint	sprint
mont	mont
acta	acta
destroy	destroy
dunn	dunn
fir	fir
sept	sept
baba	baba
liebe	liebe
clyde	clyde
lego	lego
tz	tz
buda	buda
clips	clips
vicente	vicente
mosfet	mosfet
gig	gig
modulation	modulation
thoughts	thoughts
driven	driven
jf	jf
vulgaris	vulgaris
unfinished	unfinished
inferno	inferno
omg	omg
geological	geological
mlrs	mlrs
laguna	laguna
valve	valve
nigel	nigel
abbott	abbott
nash	nash
mona	mona
bud	bud
vaccine	vaccine
notorious	notorious
payne	payne
beethoven	beethoven
monkeys	monkeys
sands	sands
experiments	experiments
cobra	cobra
bien	bien
const	const
tribune	tribune
bologna	bologna
rothschild	rothschild
bolt	bolt
claudio	claudio
theoretical	theoretical
glacier	glacier
sparc	sparc
highly	highly
anger	anger
lea	lea
й	й
reactor	reactor
gev	gev
whales	whales
csf	csf
kraft	kraft
privacy	privacy
rwanda	rwanda
sei	sei
insight	insight
measures	measures
reyes	reyes
sold	sold
confederate	confederate
yoo	yoo
dwight	dwight
beloved	beloved
lakes	lakes
igm	igm
weiss	weiss
maestro	maestro
guatemala	guatemala
elias	elias
genealogy	genealogy
epr	epr
jit	jit
bunker	bunker
cassell	cassell
slc	slc
bears	bears
sadness	sadness
nude	nude
nationalism	nationalism
botany	botany
santana	santana
icann	icann
bibcode	bibcode
gibbs	gibbs
hollow	hollow
sensor	sensor
atari	atari
diplomatic	diplomatic
snyder	snyder
interviews	interviews
harald	harald
fleming	fleming
fide	fide
mat	mat
sergei	sergei
compass	compass
lucius	lucius
lis	lis
revolt	revolt
bloch	bloch
prisoner	prisoner
sein	sein
cccc	cccc
isabella	isabella
griffin	griffin
fearless	fearless
hmv	hmv
maximilian	maximilian
winchester	winchester
за	за
columbus	columbus
monetary	monetary
rubber	rubber
belief	belief
rot	rot
simmons	simmons
nie	nie
tide	tide
heavens	heavens
groovy	groovy
numeric	numeric
highlights	highlights
gage	gage
darpa	darpa
marcos	marcos
habsburg	habsburg
sven	sven
fry	fry
ponte	ponte
shirley	shirley
badge	badge
pds	pds
candle	candle
earlier	earlier
eon	eon
historian	historian
brunswick	brunswick
afro	afro
ronnie	ronnie
derived	derived
fatale	fatale
euler	euler
siegfried	siegfried
clash	clash
appear	appear
cuckoo	cuckoo
plos	plos
margarita	margarita
announced	announced
alouatta	alouatta
longest	longest
cielo	cielo
och	och
sox	sox
metabolism	metabolism
brooke	brooke
manila	manila
alexis	alexis
hastings	hastings
presto	presto
geneva	geneva
measurement	measurement
الله	الله
reunion	reunion
uprising	uprising
laurel	laurel
biblical	biblical
innocence	innocence
valerie	valerie
putnam	putnam
pointer	pointer
livre	livre
harriet	harriet
examination	examination
gaga	gaga
nac	nac
lockheed	lockheed
premiere	premiere
trailer	trailer
parents	parents
león	león
allows	allows
ink	ink
adaptive	adaptive
maine	maine
sainte	sainte
adding	adding
nuit	nuit
hassan	hassan
efficiency	efficiency
mandate	mandate
pier	pier
trumpet	trumpet
clancy	clancy
homeland	homeland
sleeping	sleeping
palestine	palestine
brandt	brandt
temps	temps
phalacrocorax	phalacrocorax
fab	fab
amos	amos
pot	pot
encounter	encounter
mafia	mafia
threat	threat
stages	stages
rolf	rolf
gum	gum
economist	economist
tanks	tanks
ais	ais
cma	cma
intervention	intervention
lone	lone
crater	crater
worker	worker
reef	reef
sami	sami
belfast	belfast
switching	switching
royale	royale
blackout	blackout
compton	compton
parma	parma
gut	gut
contrast	contrast
designed	designed
flanders	flanders
barr	barr
slovakia	slovakia
hendrik	hendrik
bomber	bomber
phosphate	phosphate
atlético	atlético
actions	actions
components	components
grain	grain
wax	wax
mayo	mayo
floyd	floyd
tested	tested
wooden	wooden
seeds	seeds
hochschule	hochschule
columba	columba
raphael	raphael
cisco	cisco
attempt	attempt
marguerite	marguerite
benny	benny
gigas	gigas
rar	rar
eps	eps
natalia	natalia
novels	novels
dodge	dodge
ug	ug
thou	thou
mackenzie	mackenzie
primer	primer
hang	hang
pinus	pinus
earthquake	earthquake
grenade	grenade
weiß	weiß
cert	cert
inn	inn
preston	preston
logistics	logistics
basics	basics
uta	uta
bandeira	bandeira
medici	medici
helper	helper
cone	cone
plans	plans
undefined	undefined
moldova	moldova
antarctic	antarctic
vapen	vapen
alberta	alberta
osu	osu
barrier	barrier
lullaby	lullaby
dar	dar
digest	digest
barker	barker
nur	nur
étude	étude
shy	shy
ballet	ballet
stable	stable
zodiac	zodiac
buttons	buttons
persona	persona
armenia	armenia
morales	morales
frei	frei
evan	evan
histories	histories
martín	martín
debian	debian
vhdl	vhdl
kramer	kramer
daylight	daylight
tow	tow
monitoring	monitoring
xix	xix
minds	minds
motivation	motivation
lepilemur	lepilemur
reina	reina
adsl	adsl
fragment	fragment
rip	rip
teu	teu
predator	predator
enrico	enrico
arturo	arturo
holly	holly
geoff	geoff
meu	meu
increase	increase
walther	walther
nathaniel	nathaniel
penn	penn
mimi	mimi
andrés	andrés
adolphe	adolphe
brewer	brewer
sopa	sopa
squid	squid
adm	adm
portraits	portraits
efi	efi
flynn	flynn
personnel	personnel
acquisition	acquisition
fuse	fuse
defenders	defenders
priority	priority
alicia	alicia
skidmore	skidmore
shen	shen
mandatory	mandatory
ibrahim	ibrahim
uruguay	uruguay
maiden	maiden
academia	academia
efficient	efficient
crusade	crusade
zimbabwe	zimbabwe
qatar	qatar
x_j	x_j
xz	xz
schema	schema
schloss	schloss
arbor	arbor
dimensional	dimensional
hurt	hurt
zebra	zebra
mood	mood
persons	persons
reporting	reporting
definitely	definitely
radioactive	radioactive
gómez	gómez
aquarium	aquarium
treatise	treatise
lancaster	lancaster
morton	morton
boulevard	boulevard
cooh	cooh
watt	watt
nuts	nuts
niels	niels
ramsay	ramsay
barnard	barnard
lynch	lynch
crimes	crimes
sergeant	sergeant
easter	easter
lexington	lexington
ubuntu	ubuntu
ptolemy	ptolemy
unless	unless
chevalier	chevalier
preferences	preferences
twentieth	twentieth
weaver	weaver
olga	olga
karin	karin
pix	pix
largo	largo
tok	tok
citizens	citizens
delay	delay
κ	κ
jacket	jacket
dalton	dalton
italiana	italiana
tristan	tristan
missions	missions
wrap	wrap
domingo	domingo
gackt	gackt
emc	emc
empires	empires
cba	cba
valle	valle
supplement	supplement
notices	notices
gruyter	gruyter
bias	bias
_shoulder_stripes_white_stripes	_shoulder_stripes_white_stripes
paix	paix
windsor	windsor
jets	jets
ecc	ecc
quote	quote
primera	primera
graffiti	graffiti
deo	deo
described	described
observation	observation
arabian	arabian
mes	mes
louvre	louvre
communism	communism
benefit	benefit
strict	strict
hon	hon
teeth	teeth
jill	jill
csm	csm
equations	equations
cure	cure
cruiser	cruiser
chateau	chateau
dpkg	dpkg
cfm	cfm
poverty	poverty
laboratories	laboratories
flies	flies
nino	nino
southwest	southwest
permissions	permissions
silicon	silicon
typical	typical
strauss	strauss
chin	chin
p_k	p_k
airline	airline
américa	américa
upgrade	upgrade
toll	toll
conquest	conquest
stefano	stefano
entire	entire
methyl	methyl
howe	howe
vms	vms
manifesto	manifesto
judgment	judgment
accounting	accounting
camille	camille
tucker	tucker
everywhere	everywhere
creed	creed
credits	credits
correction	correction
myers	myers
rust	rust
receiver	receiver
latitude	latitude
slavery	slavery
helsinki	helsinki
allgemeine	allgemeine
ber	ber
happened	happened
wtf	wtf
sudden	sudden
traveling	traveling
spotlight	spotlight
completed	completed
cobol	cobol
timeaxis	timeaxis
seds	seds
introducing	introducing
connecticut	connecticut
ritual	ritual
migration	migration
hush	hush
normandy	normandy
duel	duel
container	container
colored	colored
concolor	concolor
mesoplodon	mesoplodon
clair	clair
corn	corn
tee	tee
_blueshoulders	_blueshoulders
ricky	ricky
marines	marines
campo	campo
datavalue	datavalue
isr	isr
nokia	nokia
inquiry	inquiry
ism	ism
rossi	rossi
worldcat	worldcat
rodgers	rodgers
heer	heer
starr	starr
hammond	hammond
mining	mining
sia	sia
checked	checked
eddy	eddy
gaston	gaston
angry	angry
parliamentary	parliamentary
opposition	opposition
decay	decay
survive	survive
discrimination	discrimination
dieter	dieter
mater	mater
diss	diss
indianapolis	indianapolis
ariel	ariel
qd	qd
dietrich	dietrich
export	export
entries	entries
bradford	bradford
capitalism	capitalism
ale	ale
substance	substance
yoga	yoga
hellenic	hellenic
crying	crying
minimal	minimal
frédéric	frédéric
norris	norris
farmer	farmer
majesty	majesty
ari	ari
happen	happen
twisted	twisted
thursday	thursday
divided	divided
cairo	cairo
whom	whom
subscription	subscription
admin	admin
ppt	ppt
ont	ont
wikibase	wikibase
barton	barton
emilio	emilio
numerical	numerical
channels	channels
newcastle	newcastle
augusta	augusta
ori	ori
comfort	comfort
attention	attention
pisa	pisa
marked	marked
answers	answers
aquila	aquila
rational	rational
monty	monty
albany	albany
ctu	ctu
edith	edith
hampshire	hampshire
kiev	kiev
ppc	ppc
lindsay	lindsay
schwartz	schwartz
henrik	henrik
tobias	tobias
fancy	fancy
gadget	gadget
gong	gong
trek	trek
importance	importance
trois	trois
spectroscopy	spectroscopy
eminem	eminem
mal	mal
serenade	serenade
boxer	boxer
meine	meine
encryption	encryption
cutting	cutting
breaks	breaks
matthews	matthews
thread	thread
bop	bop
gathering	gathering
tolerance	tolerance
romanian	romanian
kaj	kaj
torn	torn
unión	unión
marble	marble
knee	knee
erika	erika
chosen	chosen
guido	guido
journalism	journalism
toledo	toledo
printed	printed
casino	casino
amt	amt
queue	queue
unita	unita
nicaragua	nicaragua
ruiz	ruiz
mich	mich
faber	faber
dove	dove
gibraltar	gibraltar
arithmetic	arithmetic
ghosts	ghosts
displayed	displayed
philipp	philipp
delicious	delicious
ə	ə
eazy	eazy
dominican	dominican
armando	armando
yves	yves
neck	neck
weimar	weimar
stp	stp
genes	genes
objective	objective
elena	elena
mfc	mfc
scandal	scandal
ahmad	ahmad
_redborder	_redborder
archaeological	archaeological
auckland	auckland
carr	carr
ocr	ocr
macintosh	macintosh
algol	algol
towns	towns
accepted	accepted
agenda	agenda
angus	angus
roche	roche
cst	cst
sem	sem
apocalypse	apocalypse
ghetto	ghetto
clone	clone
sixteen	sixteen
hannover	hannover
trinidad	trinidad
plato	plato
purchase	purchase
harvest	harvest
morrow	morrow
colonies	colonies
penny	penny
finn	finn
goldberg	goldberg
tram	tram
eleanor	eleanor
occidentalis	occidentalis
hindu	hindu
holds	holds
shade	shade
claim	claim
touring	touring
duchy	duchy
poe	poe
moss	moss
polydor	polydor
libri	libri
titans	titans
mole	mole
tender	tender
olivier	olivier
arcadia	arcadia
babel	babel
nitro	nitro
monk	monk
accept	accept
blocked	blocked
confession	confession
peuple	peuple
dello	dello
cva	cva
scholarship	scholarship
hare	hare
jms	jms
dice	dice
apo	apo
ica	ica
emotional	emotional
tes	tes
cheng	cheng
teachers	teachers
cristina	cristina
imo	imo
augustine	augustine
epoch	epoch
outdoor	outdoor
sho	sho
palau	palau
organizations	organizations
sie	sie
soe	soe
registered	registered
oman	oman
gina	gina
pond	pond
martyrs	martyrs
fold	fold
hoffman	hoffman
corona	corona
xk	xk
mainz	mainz
deborah	deborah
río	río
romero	romero
galactic	galactic
département	département
insane	insane
sparks	sparks
rag	rag
ack	ack
dolce	dolce
denise	denise
basin	basin
streets	streets
tier	tier
qg	qg
toby	toby
alarm	alarm
bash	bash
cine	cine
beau	beau
covered	covered
regulus	regulus
willis	willis
domino	domino
shoe	shoe
theories	theories
samantha	samantha
saved	saved
nueva	nueva
naomi	naomi
abcd	abcd
aeg	aeg
rhinoceros	rhinoceros
lund	lund
equity	equity
eros	eros
perhaps	perhaps
في	في
dpi	dpi
continuum	continuum
bgb	bgb
aureus	aureus
sax	sax
shan	shan
sousa	sousa
♦	♦
hess	hess
spike	spike
neptune	neptune
nassau	nassau
fetch	fetch
swords	swords
ι	ι
destroyer	destroyer
prepared	prepared
dall	dall
enlightenment	enlightenment
harding	harding
vernon	vernon
aperture	aperture
stability	stability
père	père
proposals	proposals
budokan	budokan
cecil	cecil
jaguar	jaguar
spiders	spiders
bohemian	bohemian
daf	daf
alter	alter
minneapolis	minneapolis
rana	rana
sutton	sutton
shout	shout
mexicana	mexicana
pill	pill
barra	barra
wealth	wealth
fang	fang
todo	todo
augsburg	augsburg
á	á
nikki	nikki
realm	realm
customs	customs
lime	lime
cfb	cfb
iihf	iihf
revelation	revelation
ambassador	ambassador
blogs	blogs
siam	siam
sandra	sandra
compendium	compendium
pathway	pathway
curry	curry
instructions	instructions
managing	managing
improve	improve
y_n	y_n
preservation	preservation
partition	partition
evergreen	evergreen
rotten	rotten
celebrate	celebrate
goodman	goodman
александр	александр
bourbon	bourbon
ani	ani
andromeda	andromeda
calculator	calculator
fútbol	fútbol
deadly	deadly
followed	followed
emerson	emerson
isabel	isabel
ucs	ucs
soleil	soleil
headed	headed
guid	guid
magdalena	magdalena
nashville	nashville
africanus	africanus
bert	bert
dock	dock
beatrice	beatrice
torino	torino
jacqueline	jacqueline
casting	casting
bombs	bombs
concise	concise
coral	coral
cmp	cmp
balloon	balloon
cappella	cappella
xvii	xvii
difficult	difficult
doctors	doctors
gavin	gavin
abandoned	abandoned
correspondence	correspondence
biggest	biggest
ante	ante
granada	granada
logan	logan
suzanne	suzanne
appeared	appeared
brendan	brendan
praha	praha
constitutional	constitutional
kam	kam
architect	architect
surveillance	surveillance
dial	dial
ey	ey
fiat	fiat
hunger	hunger
older	older
zinc	zinc
snap	snap
sera	sera
permission	permission
territories	territories
passing	passing
moritz	moritz
serbian	serbian
fucking	fucking
sauce	sauce
skies	skies
symmetry	symmetry
dish	dish
quasi	quasi
duchess	duchess
scalemajor	scalemajor
runs	runs
л	л
allmusic	allmusic
powerful	powerful
cpa	cpa
sal	sal
dcs	dcs
travels	travels
clr	clr
effort	effort
butcher	butcher
coal	coal
beaux	beaux
tight	tight
émile	émile
heron	heron
nis	nis
tenerife	tenerife
divide	divide
hanover	hanover
welfare	welfare
armee	armee
provincial	provincial
glorious	glorious
selective	selective
baxter	baxter
feelings	feelings
cbu	cbu
citations	citations
headquarters	headquarters
feather	feather
bryce	bryce
ora	ora
translator	translator
picasso	picasso
braun	braun
ethernet	ethernet
victims	victims
juno	juno
anthropology	anthropology
prairie	prairie
movements	movements
hayes	hayes
nite	nite
computation	computation
waterloo	waterloo
matlab	matlab
generally	generally
brussels	brussels
remain	remain
peta	peta
bare	bare
z_n	z_n
consumption	consumption
merrill	merrill
atf	atf
kda	kda
wrote	wrote
asm	asm
semantic	semantic
overseas	overseas
associations	associations
picea	picea
cuda	cuda
hymn	hymn
uma	uma
samba	samba
chem	chem
roads	roads
asset	asset
nichols	nichols
danielle	danielle
creep	creep
plug	plug
nextstep	nextstep
tempest	tempest
katie	katie
riding	riding
andrei	andrei
grimm	grimm
wearing	wearing
waking	waking
integrity	integrity
ashes	ashes
perrin	perrin
pale	pale
discourse	discourse
representative	representative
anno	anno
pip	pip
guerre	guerre
vital	vital
psk	psk
dea	dea
abyss	abyss
cunningham	cunningham
fossil	fossil
automated	automated
ter	ter
weg	weg
tooth	tooth
damn	damn
bleu	bleu
goddess	goddess
grandes	grandes
р	р
souza	souza
doors	doors
fiji	fiji
thick	thick
siempre	siempre
étienne	étienne
haus	haus
religions	religions
follows	follows
romana	romana
grip	grip
etat	etat
divisions	divisions
syrian	syrian
volunteer	volunteer
pirate	pirate
trespass	trespass
depression	depression
breakthrough	breakthrough
listening	listening
metallica	metallica
engel	engel
grus	grus
designation	designation
chancellor	chancellor
polytechnic	polytechnic
centrale	centrale
lexikon	lexikon
authentication	authentication
eines	eines
mikhail	mikhail
fou	fou
chop	chop
engagement	engagement
welsh	welsh
gradient	gradient
strait	strait
pipes	pipes
equality	equality
español	español
eating	eating
influences	influences
restaurant	restaurant
harlem	harlem
hannibal	hannibal
stanisław	stanisław
pseudo	pseudo
sint	sint
maggie	maggie
roar	roar
ottawa	ottawa
longitude	longitude
miracles	miracles
hover	hover
chronic	chronic
julien	julien
mojo	mojo
tara	tara
banking	banking
setup	setup
pereira	pereira
moor	moor
mwc	mwc
nyu	nyu
mesa	mesa
aida	aida
contributor	contributor
viper	viper
curiosity	curiosity
cecilia	cecilia
coastal	coastal
uzbekistan	uzbekistan
trauma	trauma
bremen	bremen
barrow	barrow
volunteers	volunteers
ιωάννης	ιωάννης
new_args	new_args
coupe	coupe
browning	browning
warwick	warwick
birmingham	birmingham
gist	gist
northwestern	northwestern
berger	berger
funeral	funeral
doyle	doyle
cpl	cpl
rural	rural
salle	salle
revert	revert
reported	reported
deb	deb
bauer	bauer
erin	erin
otis	otis
juli	juli
vitamin	vitamin
robbie	robbie
mondo	mondo
bcd	bcd
не	не
pps	pps
populus	populus
gamer	gamer
terrible	terrible
lena	lena
discovered	discovered
characteristics	characteristics
togo	togo
bois	bois
bohemia	bohemia
fauna	fauna
parque	parque
painted	painted
grep	grep
rodrigo	rodrigo
bernstein	bernstein
rosen	rosen
kon	kon
fundamentals	fundamentals
mako	mako
_blackborder	_blackborder
sammy	sammy
boyfriend	boyfriend
lyric	lyric
majority	majority
unam	unam
gauge	gauge
athena	athena
isabelle	isabelle
devils	devils
karel	karel
meteor	meteor
noon	noon
dis	dis
fisheries	fisheries
montage	montage
francois	francois
possibility	possibility
administrative	administrative
copenhagen	copenhagen
siemens	siemens
augustin	augustin
blizzard	blizzard
musée	musée
unexpected	unexpected
loco	loco
arctos	arctos
paparazzi	paparazzi
voor	voor
nel	nel
rousseau	rousseau
defeat	defeat
impression	impression
strasbourg	strasbourg
joanna	joanna
shelter	shelter
annette	annette
topographic	topographic
lack	lack
wednesday	wednesday
virtue	virtue
utm	utm
checking	checking
swat	swat
donovan	donovan
yin	yin
mistake	mistake
epp	epp
cdi	cdi
futebol	futebol
ginger	ginger
controlled	controlled
orders	orders
nacht	nacht
æ	æ
patient	patient
albrecht	albrecht
brook	brook
isolation	isolation
hilton	hilton
puppy	puppy
ptsd	ptsd
appendix	appendix
m_n	m_n
revolver	revolver
sheikh	sheikh
sacrifice	sacrifice
vpn	vpn
junk	junk
lodge	lodge
vinci	vinci
priest	priest
reboot	reboot
tos	tos
claus	claus
banda	banda
affect	affect
fils	fils
rape	rape
vessel	vessel
lara	lara
anita	anita
moll	moll
coord	coord
württemberg	württemberg
mifflin	mifflin
melo	melo
amelia	amelia
mro	mro
v_n	v_n
spam	spam
garage	garage
taurus	taurus
horses	horses
curriculum	curriculum
ф	ф
iglesia	iglesia
deportivo	deportivo
dtm	dtm
_adidasonwhite	_adidasonwhite
maze	maze
nap	nap
tis	tis
iranian	iranian
announcement	announcement
uu	uu
amherst	amherst
canine	canine
lfsr	lfsr
attacks	attacks
gbps	gbps
stephens	stephens
carrie	carrie
succession	succession
veil	veil
oldest	oldest
grammophon	grammophon
fell	fell
awareness	awareness
poetic	poetic
hound	hound
ballads	ballads
macau	macau
preserve	preserve
_x	_x
continent	continent
younger	younger
ruins	ruins
bigger	bigger
railways	railways
stated	stated
fal	fal
moderne	moderne
wcf	wcf
abd	abd
markus	markus
childhood	childhood
nowiki	nowiki
levels	levels
lit	lit
esther	esther
watts	watts
fuchs	fuchs
profiles	profiles
trends	trends
gymnasium	gymnasium
swamp	swamp
relational	relational
lucifer	lucifer
yorkshire	yorkshire
kahn	kahn
wilkinson	wilkinson
korn	korn
gan	gan
gin	gin
searching	searching
conductor	conductor
arial	arial
bliss	bliss
buster	buster
reconnaissance	reconnaissance
italiano	italiano
francesca	francesca
sachsen	sachsen
wellington	wellington
konami	konami
mens	mens
hosts	hosts
asked	asked
marilyn	marilyn
warcraft	warcraft
porta	porta
musicians	musicians
throne	throne
blonde	blonde
mcdonnell	mcdonnell
palgrave	palgrave
armée	armée
fifty	fifty
__notoc__	__notoc__
servant	servant
mort	mort
з	з
conception	conception
coupling	coupling
fee	fee
ratp	ratp
tortoise	tortoise
crusades	crusades
daniels	daniels
mendoza	mendoza
kar	kar
uy	uy
sciurus	sciurus
mist	mist
palermo	palermo
anzac	anzac
ended	ended
shaped	shaped
nai	nai
ella	ella
surrey	surrey
trent	trent
upi	upi
rudolph	rudolph
plotarea	plotarea
patton	patton
organizational	organizational
lola	lola
lorenz	lorenz
ov	ov
gmail	gmail
tension	tension
andersen	andersen
coordinates	coordinates
developing	developing
venture	venture
nell	nell
yum	yum
meier	meier
email	email
pittsburgh	pittsburgh
celeste	celeste
relating	relating
dinosaurs	dinosaurs
_thinwhitesides	_thinwhitesides
vince	vince
sind	sind
diseases	diseases
eliot	eliot
vertigo	vertigo
martial	martial
plata	plata
invincible	invincible
rbi	rbi
controversy	controversy
caltech	caltech
flute	flute
scholars	scholars
f_k	f_k
seems	seems
deeper	deeper
copies	copies
spell	spell
themselves	themselves
potassium	potassium
germain	germain
maid	maid
pspace	pspace
moody	moody
pkk	pkk
hermes	hermes
adds	adds
sail	sail
protest	protest
werke	werke
sensation	sensation
hahn	hahn
geometric	geometric
raj	raj
essen	essen
baltic	baltic
pius	pius
bergen	bergen
__noeditsection__	__noeditsection__
stroke	stroke
österreich	österreich
cbd	cbd
feeding	feeding
cultures	cultures
streaming	streaming
neumann	neumann
perez	perez
elaine	elaine
policies	policies
hebrew	hebrew
pico	pico
kaufmann	kaufmann
sweat	sweat
anywhere	anywhere
baroque	baroque
mais	mais
aftermath	aftermath
deu	deu
primitive	primitive
vengeance	vengeance
randolph	randolph
guards	guards
prophet	prophet
tre	tre
más	más
analytical	analytical
extinct	extinct
domine	domine
coca	coca
jens	jens
rz	rz
république	république
scales	scales
scripts	scripts
evelyn	evelyn
legendary	legendary
pitchfork	pitchfork
tissue	tissue
optics	optics
stalin	stalin
babe	babe
cruel	cruel
realism	realism
discipline	discipline
func	func
kissed	kissed
latvia	latvia
feels	feels
collector	collector
unusual	unusual
anterior	anterior
chasing	chasing
zw	zw
bandai	bandai
gunnar	gunnar
raúl	raúl
descent	descent
goose	goose
geographical	geographical
stanton	stanton
bicolor	bicolor
expressions	expressions
cbr	cbr
hawkins	hawkins
mundi	mundi
schott	schott
serge	serge
vincenzo	vincenzo
paid	paid
sturm	sturm
thief	thief
instance	instance
dios	dios
pater	pater
allocation	allocation
nascar	nascar
temptation	temptation
smoking	smoking
nora	nora
batch	batch
dateformat	dateformat
artery	artery
cheek	cheek
openoffice	openoffice
monsieur	monsieur
scholarly	scholarly
vax	vax
b_k	b_k
facade	facade
novi	novi
routing	routing
minsk	minsk
nou	nou
mineral	mineral
managed	managed
override	override
echoes	echoes
schultz	schultz
akademie	akademie
ina	ina
whiskey	whiskey
aberdeen	aberdeen
axn	axn
matthias	matthias
architectural	architectural
reliance	reliance
ethiopian	ethiopian
excel	excel
wilde	wilde
ä	ä
archibald	archibald
needle	needle
lavender	lavender
keyboards	keyboards
tunisia	tunisia
temporary	temporary
closing	closing
higgins	higgins
token	token
beneath	beneath
selling	selling
institutions	institutions
temporal	temporal
bentley	bentley
byrne	byrne
upn	upn
tina	tina
explosive	explosive
tot	tot
∨	∨
pz	pz
hustle	hustle
allium	allium
legs	legs
moments	moments
plague	plague
returned	returned
distortion	distortion
genocide	genocide
luminous	luminous
scots	scots
rum	rum
uptown	uptown
fierce	fierce
patriot	patriot
rockin	rockin
tigers	tigers
española	española
gerd	gerd
mpla	mpla
chico	chico
responsible	responsible
narrow	narrow
muntiacus	muntiacus
resident	resident
trying	trying
horizons	horizons
wwii	wwii
booth	booth
♣	♣
acting	acting
sociale	sociale
melodies	melodies
nordic	nordic
alta	alta
saas	saas
zwei	zwei
lydia	lydia
eighth	eighth
determination	determination
grown	grown
implications	implications
obscurus	obscurus
lava	lava
dummy	dummy
nossa	nossa
griffith	griffith
somalia	somalia
rhein	rhein
unreleased	unreleased
distant	distant
coda	coda
_a	_a
janusz	janusz
enix	enix
dewey	dewey
tracing	tracing
exposure	exposure
ramon	ramon
cuts	cuts
novo	novo
visitor	visitor
katy	katy
impulse	impulse
parti	parti
updates	updates
satisfaction	satisfaction
_whitesides	_whitesides
trident	trident
indie	indie
momentum	momentum
introductory	introductory
rpf	rpf
naples	naples
formosa	formosa
nautilus	nautilus
hernández	hernández
sahara	sahara
scores	scores
peggy	peggy
odessa	odessa
musician	musician
polaris	polaris
inferior	inferior
literacy	literacy
dich	dich
propulsion	propulsion
bjp	bjp
vittorio	vittorio
mmm	mmm
prevent	prevent
tough	tough
recreation	recreation
anxiety	anxiety
augusto	augusto
freiburg	freiburg
blau	blau
sala	sala
serpent	serpent
brady	brady
opened	opened
díaz	díaz
christi	christi
w_i	w_i
generals	generals
oval	oval
brewster	brewster
christophe	christophe
bender	bender
anguilla	anguilla
consider	consider
fdr	fdr
distinct	distinct
throughout	throughout
_u	_u
visitors	visitors
misery	misery
sherry	sherry
terrestrial	terrestrial
conduct	conduct
rope	rope
wallis	wallis
cor	cor
curtain	curtain
prisoners	prisoners
snes	snes
holder	holder
orf	orf
intensity	intensity
microrna	microrna
budget	budget
newport	newport
atkinson	atkinson
cylinder	cylinder
boundaries	boundaries
agents	agents
dawson	dawson
healthcare	healthcare
electoral	electoral
sings	sings
buckley	buckley
winged	winged
somethin	somethin
heal	heal
weinberg	weinberg
salvation	salvation
starz	starz
truly	truly
mathworld	mathworld
marta	marta
diver	diver
aston	aston
brassica	brassica
gregorio	gregorio
lobe	lobe
sutherland	sutherland
grandis	grandis
wolff	wolff
volk	volk
beard	beard
flux	flux
locke	locke
edo	edo
vent	vent
drei	drei
weird	weird
hornet	hornet
polymer	polymer
leroy	leroy
inspection	inspection
tilia	tilia
killers	killers
awk	awk
hesse	hesse
indies	indies
advice	advice
armand	armand
prose	prose
neighbor	neighbor
antigen	antigen
treat	treat
isi	isi
locus	locus
shane	shane
marker	marker
turtles	turtles
potato	potato
beacon	beacon
finder	finder
robbins	robbins
zenith	zenith
parco	parco
quercus	quercus
charity	charity
molto	molto
mclean	mclean
mecklenburg	mecklenburg
dmx	dmx
pantheon	pantheon
honneur	honneur
kingdoms	kingdoms
keeping	keeping
moro	moro
dupont	dupont
mcgill	mcgill
jury	jury
ascension	ascension
laurie	laurie
lighthouse	lighthouse
bison	bison
olympia	olympia
disabled	disabled
definitive	definitive
croix	croix
sculpture	sculpture
gli	gli
removal	removal
everytime	everytime
mister	mister
gambia	gambia
éditions	éditions
exclusion	exclusion
manfred	manfred
guru	guru
tumor	tumor
posted	posted
connell	connell
representatives	representatives
giacomo	giacomo
rebels	rebels
strikes	strikes
ria	ria
tec	tec
asteroid	asteroid
hussein	hussein
norfolk	norfolk
publicationdate	publicationdate
ángel	ángel
anarchy	anarchy
osborne	osborne
martins	martins
facing	facing
solitude	solitude
fiona	fiona
elsevier	elsevier
oskar	oskar
expect	expect
_t	_t
pinto	pinto
duplex	duplex
javanicus	javanicus
victorian	victorian
housing	housing
wrapper	wrapper
formatting	formatting
islas	islas
sulcus	sulcus
hungry	hungry
foods	foods
córdoba	córdoba
nail	nail
croce	croce
saying	saying
goldman	goldman
ike	ike
r_n	r_n
poets	poets
frederic	frederic
fuller	fuller
postal	postal
pasha	pasha
orchard	orchard
alignment	alignment
holstein	holstein
reagan	reagan
sailor	sailor
gurls	gurls
runway	runway
forbidden	forbidden
kraków	kraków
sulfate	sulfate
g_n	g_n
mauritius	mauritius
caused	caused
amo	amo
outlook	outlook
nmc	nmc
armored	armored
automobile	automobile
apis	apis
endurance	endurance
earliest	earliest
congressional	congressional
relativity	relativity
conservative	conservative
toni	toni
toolkit	toolkit
blessed	blessed
ivory	ivory
defaults	defaults
rubin	rubin
wikia	wikia
isdn	isdn
castillo	castillo
sag	sag
quantitative	quantitative
bea	bea
paste	paste
lowell	lowell
reservoir	reservoir
warp	warp
spatial	spatial
dup	dup
badger	badger
castel	castel
xxxholic	xxxholic
cinerea	cinerea
epub	epub
arctocephalus	arctocephalus
cristatus	cristatus
estado	estado
caucasus	caucasus
tibet	tibet
observed	observed
deployment	deployment
compiled	compiled
elton	elton
cerro	cerro
wes	wes
humanity	humanity
scanning	scanning
aime	aime
thierry	thierry
refugees	refugees
actors	actors
dinner	dinner
brenda	brenda
tabs	tabs
exhibit	exhibit
idaho	idaho
compression	compression
federico	federico
arrows	arrows
ape	ape
tome	tome
dickinson	dickinson
mostly	mostly
jubilee	jubilee
sable	sable
crack	crack
ras	ras
becoming	becoming
assassin	assassin
dune	dune
nsf	nsf
crowned	crowned
petite	petite
waterfall	waterfall
palma	palma
lui	lui
tsr	tsr
electricity	electricity
pavel	pavel
nutrition	nutrition
alonso	alonso
chord	chord
crowd	crowd
overflow	overflow
manuscripts	manuscripts
jobs	jobs
edmond	edmond
nasty	nasty
naca	naca
reflex	reflex
mediterranean	mediterranean
ola	ola
geek	geek
aristotle	aristotle
robotics	robotics
reporter	reporter
runtime	runtime
camel	camel
elevator	elevator
skills	skills
deen	deen
gazella	gazella
mta	mta
audrey	audrey
papaver	papaver
mediation	mediation
transformers	transformers
mechanisms	mechanisms
józef	józef
antigua	antigua
significance	significance
injury	injury
icmp	icmp
johanna	johanna
purge	purge
haut	haut
stores	stores
complexity	complexity
gazette	gazette
suspension	suspension
lra	lra
hancock	hancock
pawn	pawn
ortiz	ortiz
crossroads	crossroads
safari	safari
bonds	bonds
eugen	eugen
altar	altar
jts	jts
tas	tas
propithecus	propithecus
melvin	melvin
vila	vila
congregatio	congregatio
ausf	ausf
brush	brush
stations	stations
cesare	cesare
nicholson	nicholson
emerald	emerald
mess	mess
strategies	strategies
delaware	delaware
bid	bid
dillon	dillon
asic	asic
elvis	elvis
perkins	perkins
strangers	strangers
valentin	valentin
bpp	bpp
silk	silk
jennings	jennings
inspector	inspector
leftarrow	leftarrow
folklore	folklore
tug	tug
marginal	marginal
thru	thru
fuzzy	fuzzy
completely	completely
ernesto	ernesto
pubmed	pubmed
enemies	enemies
compagnie	compagnie
toulouse	toulouse
harm	harm
pamela	pamela
guardians	guardians
feast	feast
continued	continued
sinclair	sinclair
halle	halle
patrie	patrie
emanuel	emanuel
hessen	hessen
cart	cart
félix	félix
cuban	cuban
prosper	prosper
sting	sting
janeiro	janeiro
castles	castles
haunted	haunted
jesús	jesús
freddy	freddy
hyperion	hyperion
licensed	licensed
suny	suny
thirteen	thirteen
carlton	carlton
dare	dare
advertising	advertising
poco	poco
salem	salem
soda	soda
freud	freud
yz	yz
idiot	idiot
unicorn	unicorn
married	married
dirt	dirt
eritrea	eritrea
delivered	delivered
scarecrow	scarecrow
scribner	scribner
balkans	balkans
п	п
graves	graves
smiley	smiley
sour	sour
fdl	fdl
homer	homer
riddle	riddle
chant	chant
latina	latina
fruits	fruits
capo	capo
dolby	dolby
titus	titus
webm	webm
levine	levine
mus	mus
creatures	creatures
igf	igf
leer	leer
staphylococcus	staphylococcus
reproduction	reproduction
mustafa	mustafa
rockefeller	rockefeller
ipx	ipx
geffen	geffen
guggenheim	guggenheim
claudius	claudius
willard	willard
semper	semper
lied	lied
chamberlain	chamberlain
citadel	citadel
desde	desde
springfield	springfield
rockets	rockets
behavioral	behavioral
puppet	puppet
beliefs	beliefs
sanctus	sanctus
musa	musa
wiktionary	wiktionary
jukebox	jukebox
sloan	sloan
assume	assume
chick	chick
cockpit	cockpit
reginald	reginald
commissioner	commissioner
sibirica	sibirica
learned	learned
hoffmann	hoffmann
holidays	holidays
canberra	canberra
laugh	laugh
stolen	stolen
dhcp	dhcp
xperia	xperia
vers	vers
liability	liability
asiatic	asiatic
teach	teach
copyleft	copyleft
thessaloniki	thessaloniki
chinatown	chinatown
grants	grants
attitude	attitude
tobacco	tobacco
transistor	transistor
numb	numb
ctr	ctr
franca	franca
sheffield	sheffield
apus	apus
fer	fer
simons	simons
constantine	constantine
stuck	stuck
chapters	chapters
ascap	ascap
cord	cord
inspiration	inspiration
senegal	senegal
heller	heller
alle	alle
apologies	apologies
wicked	wicked
fontana	fontana
psd	psd
clothes	clothes
edx	edx
doris	doris
extraordinary	extraordinary
ordo	ordo
من	من
rockstar	rockstar
antonia	antonia
shepard	shepard
omnibus	omnibus
burundi	burundi
sears	sears
rib	rib
miriam	miriam
ю	ю
byzantine	byzantine
jaime	jaime
turns	turns
ligo	ligo
mussolini	mussolini
reformation	reformation
ans	ans
phenomena	phenomena
lexicon	lexicon
releases	releases
reply	reply
satan	satan
hoboken	hoboken
ы	ы
mongol	mongol
boyle	boyle
martyr	martyr
boer	boer
ramírez	ramírez
lunch	lunch
cygnus	cygnus
wilder	wilder
regis	regis
sensory	sensory
distorted	distorted
hardcover	hardcover
exact	exact
burger	burger
scattering	scattering
ritchie	ritchie
plateau	plateau
dartmouth	dartmouth
analytic	analytic
blocks	blocks
hydra	hydra
watching	watching
frankie	frankie
zeitschrift	zeitschrift
tal	tal
hunters	hunters
alec	alec
braunschweig	braunschweig
lean	lean
catedral	catedral
lester	lester
een	een
sine	sine
ruff	ruff
acad	acad
ivoire	ivoire
bazaar	bazaar
showcase	showcase
gore	gore
meal	meal
gustavo	gustavo
hearing	hearing
ramsey	ramsey
dada	dada
vowel	vowel
clinic	clinic
lying	lying
pagename	pagename
eurasia	eurasia
mounted	mounted
côte	côte
shame	shame
guillermo	guillermo
eudyptes	eudyptes
strain	strain
malone	malone
concentration	concentration
ссср	ссср
travail	travail
captured	captured
tiffany	tiffany
spectral	spectral
cdna	cdna
slaves	slaves
dora	dora
shapiro	shapiro
cryptography	cryptography
covenant	covenant
sevilla	sevilla
harpercollins	harpercollins
okh	okh
ecological	ecological
nox	nox
empirical	empirical
felt	felt
arias	arias
reception	reception
dilemma	dilemma
neither	neither
meles	meles
loch	loch
rogue	rogue
ij	ij
kaplan	kaplan
nafta	nafta
chips	chips
climbing	climbing
wpf	wpf
millions	millions
ritz	ritz
humboldt	humboldt
trash	trash
seminar	seminar
pilgrim	pilgrim
trains	trains
concord	concord
sino	sino
ı	ı
ofi	ofi
npd	npd
hooker	hooker
inhibitor	inhibitor
neuroscience	neuroscience
bacteria	bacteria
volta	volta
ignored	ignored
garfield	garfield
judgement	judgement
honors	honors
technological	technological
stops	stops
gomez	gomez
damned	damned
cynthia	cynthia
surveys	surveys
tigris	tigris
cpt	cpt
rosenberg	rosenberg
chill	chill
watchlist	watchlist
oy	oy
galerie	galerie
blanche	blanche
revealed	revealed
elimination	elimination
stark	stark
surrounding	surrounding
martini	martini
mond	mond
bataille	bataille
curious	curious
durch	durch
spartak	spartak
ena	ena
urbana	urbana
simplex	simplex
challenges	challenges
enfants	enfants
slot	slot
districts	districts
caro	caro
polynesia	polynesia
meister	meister
fédération	fédération
parser	parser
selector	selector
buried	buried
reinhold	reinhold
katz	katz
surf	surf
usmc	usmc
crab	crab
mara	mara
klub	klub
vulnerable	vulnerable
województwo	województwo
attributes	attributes
mathers	mathers
zachary	zachary
principe	principe
rats	rats
fim	fim
dental	dental
vlc	vlc
airliners	airliners
easier	easier
macropus	macropus
helping	helping
♠	♠
larsson	larsson
afrique	afrique
vascular	vascular
howstuffworks	howstuffworks
recipes	recipes
mci	mci
debug	debug
nile	nile
dimensions	dimensions
madeleine	madeleine
elmer	elmer
didier	didier
piotr	piotr
thornton	thornton
filippo	filippo
freeze	freeze
macht	macht
marseille	marseille
champagne	champagne
tribal	tribal
giulio	giulio
loire	loire
tat	tat
differences	differences
mauro	mauro
petra	petra
globalization	globalization
photographer	photographer
rolls	rolls
bund	bund
becomes	becomes
kidd	kidd
accuracy	accuracy
droit	droit
goin	goin
accent	accent
salisbury	salisbury
inscription	inscription
corruption	corruption
rhode	rhode
abroad	abroad
experiences	experiences
patients	patients
tips	tips
yamaha	yamaha
tra	tra
alf	alf
unreal	unreal
judaism	judaism
asc	asc
irs	irs
gwt	gwt
refugee	refugee
lausanne	lausanne
roulette	roulette
latino	latino
africana	africana
zimmer	zimmer
constance	constance
dayz	dayz
fragile	fragile
daughters	daughters
itc	itc
pigs	pigs
amadeus	amadeus
durham	durham
nemesis	nemesis
bab	bab
vulcan	vulcan
suns	suns
clare	clare
iguana	iguana
cheers	cheers
ddc	ddc
witches	witches
paulus	paulus
fuscus	fuscus
bind	bind
technische	technische
sachs	sachs
detector	detector
ninth	ninth
campaigns	campaigns
msds	msds
burial	burial
bas	bas
gravitational	gravitational
يا	يا
handbuch	handbuch
canterbury	canterbury
bordeaux	bordeaux
favourite	favourite
northrop	northrop
iit	iit
ordre	ordre
petroleum	petroleum
vine	vine
discover	discover
esprit	esprit
eruption	eruption
naoh	naoh
summa	summa
reduced	reduced
denver	denver
institutes	institutes
seeing	seeing
owens	owens
atkins	atkins
jahre	jahre
avery	avery
inheritance	inheritance
azul	azul
quake	quake
prs	prs
inventory	inventory
medina	medina
rapids	rapids
regime	regime
mts	mts
supports	supports
costs	costs
lune	lune
exposition	exposition
malik	malik
lung	lung
elephas	elephas
habitat	habitat
zurich	zurich
quark	quark
yx	yx
imperator	imperator
cousin	cousin
clemens	clemens
disorders	disorders
raised	raised
riverside	riverside
prints	prints
jsf	jsf
browne	browne
accelerator	accelerator
heil	heil
groves	groves
albus	albus
fbc	fbc
rav	rav
mehmet	mehmet
curves	curves
fragments	fragments
topology	topology
bernardo	bernardo
communis	communis
denial	denial
pcp	pcp
affinis	affinis
pubescens	pubescens
venom	venom
tribes	tribes
sovereign	sovereign
sich	sich
freddie	freddie
servers	servers
okw	okw
represent	represent
pathology	pathology
basement	basement
protocols	protocols
reel	reel
___	___
ما	ما
nearly	nearly
notte	notte
complicated	complicated
asylum	asylum
ryder	ryder
advancement	advancement
cyril	cyril
approaches	approaches
hawks	hawks
wheels	wheels
destroyed	destroyed
aren	aren
tattoo	tattoo
regio	regio
pivot	pivot
shelley	shelley
activision	activision
emmy	emmy
generated	generated
manner	manner
quand	quand
explain	explain
hdi	hdi
restriction	restriction
brit	brit
seals	seals
cve	cve
conversation	conversation
weir	weir
pls	pls
acth	acth
scaleminor	scaleminor
sip	sip
horst	horst
allies	allies
borg	borg
carta	carta
tongue	tongue
mss	mss
ric	ric
ici	ici
deprecated	deprecated
bills	bills
megan	megan
ehre	ehre
ejb	ejb
barn	barn
ezra	ezra
cyp	cyp
huge	huge
fedora	fedora
davenport	davenport
sabbath	sabbath
amir	amir
eurasian	eurasian
conspiracy	conspiracy
oleg	oleg
larsen	larsen
coil	coil
salvatore	salvatore
pokémon	pokémon
nixon	nixon
physiology	physiology
dani	dani
vanguard	vanguard
awarded	awarded
harrier	harrier
radeon	radeon
sunt	sunt
spectacular	spectacular
emacs	emacs
jew	jew
prinz	prinz
sativa	sativa
meridian	meridian
mira	mira
savannah	savannah
l_n	l_n
général	général
honduras	honduras
wear	wear
dating	dating
planes	planes
enzyme	enzyme
phenomenon	phenomenon
nevis	nevis
pygmaeus	pygmaeus
marius	marius
hno	hno
mhnt	mhnt
hamlet	hamlet
noël	noël
borders	borders
guitars	guitars
boulder	boulder
primus	primus
dart	dart
specimen	specimen
whistle	whistle
île	île
accessible	accessible
retreat	retreat
inspired	inspired
avril	avril
deception	deception
sell	sell
mons	mons
fanny	fanny
veterans	veterans
competitive	competitive
salmon	salmon
idt	idt
bern	bern
ava	ava
exterior	exterior
charm	charm
courts	courts
shaun	shaun
ш	ш
midway	midway
kern	kern
pimp	pimp
contributors	contributors
flames	flames
armoured	armoured
inversion	inversion
diaries	diaries
rendezvous	rendezvous
gregg	gregg
introduced	introduced
nfs	nfs
dixon	dixon
pusillus	pusillus
antoinette	antoinette
hmas	hmas
iglesias	iglesias
cots	cots
iba	iba
armata	armata
ore	ore
modena	modena
sws	sws
knopf	knopf
founding	founding
insulin	insulin
ooh	ooh
eis	eis
boulogne	boulogne
romano	romano
koi	koi
whisper	whisper
apparatus	apparatus
posterior	posterior
falco	falco
smells	smells
acute	acute
isles	isles
dod	dod
kathy	kathy
signals	signals
langue	langue
gorge	gorge
domains	domains
coordination	coordination
matilda	matilda
cannes	cannes
femmes	femmes
bowen	bowen
approximation	approximation
fingers	fingers
showtime	showtime
wilderness	wilderness
première	première
walters	walters
flak	flak
robson	robson
nottingham	nottingham
resolve	resolve
kohn	kohn
kristian	kristian
snmp	snmp
kinds	kinds
saul	saul
rude	rude
argus	argus
bloomington	bloomington
andorra	andorra
hoover	hoover
mothers	mothers
chez	chez
hsp	hsp
sham	sham
calm	calm
slate	slate
mano	mano
marcia	marcia
voodoo	voodoo
mémoire	mémoire
wolfe	wolfe
mitte	mitte
magnum	magnum
kreis	kreis
fabric	fabric
wesleyan	wesleyan
vitae	vitae
candidates	candidates
rhino	rhino
sole	sole
pap	pap
exploring	exploring
a_j	a_j
pyramid	pyramid
prey	prey
extremely	extremely
yankee	yankee
bryant	bryant
québec	québec
salzburg	salzburg
daydream	daydream
chili	chili
repubblica	repubblica
unc	unc
marian	marian
vale	vale
g_i	g_i
madagascariensis	madagascariensis
mems	mems
xaml	xaml
bowling	bowling
advantage	advantage
lawn	lawn
qh	qh
josephine	josephine
biochemistry	biochemistry
sxsw	sxsw
eileen	eileen
hitman	hitman
blink	blink
i_n	i_n
tracker	tracker
sins	sins
landau	landau
z_i	z_i
mute	mute
newell	newell
starship	starship
occupied	occupied
dependency	dependency
humphrey	humphrey
léon	léon
marianne	marianne
commune	commune
uncertainty	uncertainty
naughty	naughty
steyr	steyr
baghdad	baghdad
aron	aron
aries	aries
mirrors	mirrors
clerk	clerk
believed	believed
lett	lett
numa	numa
jahr	jahr
hurd	hurd
pastor	pastor
mariana	mariana
persia	persia
nasdaq	nasdaq
statements	statements
afraid	afraid
tapes	tapes
hatched	hatched
levin	levin
forster	forster
familia	familia
f_t	f_t
centers	centers
mustang	mustang
gallus	gallus
gland	gland
addiction	addiction
highland	highland
sadie	sadie
guess	guess
triathlon	triathlon
kirby	kirby
по	по
dose	dose
respiratory	respiratory
blueprint	blueprint
noa	noa
invention	invention
voluntary	voluntary
merlin	merlin
measuring	measuring
h_i	h_i
omnia	omnia
hmg	hmg
despite	despite
shotgun	shotgun
lama	lama
hague	hague
bloomberg	bloomberg
_thinblacksides	_thinblacksides
tbilisi	tbilisi
harcourt	harcourt
freenode	freenode
painter	painter
luka	luka
sensitive	sensitive
scc	scc
voc	voc
medial	medial
interference	interference
recherche	recherche
subterranean	subterranean
electromagnetic	electromagnetic
bounty	bounty
arpanet	arpanet
portsmouth	portsmouth
rutgers	rutgers
regression	regression
în	în
roach	roach
f_x	f_x
antique	antique
caves	caves
torch	torch
collège	collège
giles	giles
sna	sna
localsettings	localsettings
almeida	almeida
moby	moby
richie	richie
fresco	fresco
lw	lw
walton	walton
sink	sink
victim	victim
fontaine	fontaine
peacock	peacock
bpi	bpi
suggestions	suggestions
bist	bist
staten	staten
alves	alves
nurse	nurse
mellon	mellon
ifrs	ifrs
cwc	cwc
campos	campos
zagreb	zagreb
modernity	modernity
godfather	godfather
lse	lse
reno	reno
senatus	senatus
marty	marty
sobre	sobre
nathalie	nathalie
mead	mead
emile	emile
ehf	ehf
monograph	monograph
confusion	confusion
lettres	lettres
hotels	hotels
teil	teil
jessie	jessie
stacked	stacked
petty	petty
eurovision	eurovision
requests	requests
jasper	jasper
worry	worry
battleship	battleship
societies	societies
balaenoptera	balaenoptera
efta	efta
hicks	hicks
swallow	swallow
mckay	mckay
forge	forge
pause	pause
isl	isl
habit	habit
ч	ч
caterpillar	caterpillar
quintus	quintus
desk	desk
suis	suis
molina	molina
cummings	cummings
scroll	scroll
redemption	redemption
nouveau	nouveau
doomsday	doomsday
honolulu	honolulu
directions	directions
mambo	mambo
chains	chains
rochester	rochester
melanie	melanie
slideshow	slideshow
textbook	textbook
hilbert	hilbert
kept	kept
domini	domini
brace	brace
feminism	feminism
civilizations	civilizations
decisions	decisions
tragic	tragic
raining	raining
griseus	griseus
replication	replication
leia	leia
oslo	oslo
lvmh	lvmh
diagnosis	diagnosis
belly	belly
dama	dama
mandarin	mandarin
luís	luís
markets	markets
napoli	napoli
laid	laid
matteo	matteo
nervous	nervous
lesbian	lesbian
cyclic	cyclic
lms	lms
sourcebook	sourcebook
wash	wash
rene	rene
rosario	rosario
coaster	coaster
emerging	emerging
anybody	anybody
scholastic	scholastic
ursula	ursula
cara	cara
mentioned	mentioned
académie	académie
hirsch	hirsch
pde	pde
manor	manor
plaque	plaque
laude	laude
striped	striped
rollback	rollback
ferreira	ferreira
republik	republik
identify	identify
conscience	conscience
scala	scala
kirche	kirche
pathfinder	pathfinder
claimed	claimed
oceanic	oceanic
modular	modular
conflicts	conflicts
terence	terence
viscount	viscount
purposes	purposes
substances	substances
officers	officers
reasonable	reasonable
ihr	ihr
faithful	faithful
gall	gall
newly	newly
pegasus	pegasus
attached	attached
mansfield	mansfield
champs	champs
westport	westport
receive	receive
cca	cca
speakers	speakers
ffdd	ffdd
zoological	zoological
servlet	servlet
penelope	penelope
mala	mala
felice	felice
americanus	americanus
ours	ours
embassy	embassy
telnet	telnet
criterion	criterion
remembrance	remembrance
justify	justify
hanna	hanna
democrat	democrat
reservation	reservation
cove	cove
vanity	vanity
developments	developments
horton	horton
saviour	saviour
assassination	assassination
sparrow	sparrow
collier	collier
ecclesia	ecclesia
marek	marek
antiquity	antiquity
rté	rté
slayer	slayer
journals	journals
noi	noi
rodrigues	rodrigues
beaver	beaver
ambystoma	ambystoma
garland	garland
benito	benito
livingston	livingston
shattered	shattered
norbert	norbert
depot	depot
dept	dept
tiempo	tiempo
ranch	ranch
pencil	pencil
winding	winding
experts	experts
jörg	jörg
saddle	saddle
vin	vin
siren	siren
missionary	missionary
quintet	quintet
hymns	hymns
employment	employment
bombay	bombay
terrace	terrace
franck	franck
submit	submit
polity	polity
preference	preference
toro	toro
mfa	mfa
studien	studien
guides	guides
snail	snail
xen	xen
coll	coll
stalingrad	stalingrad
vitro	vitro
jeans	jeans
puppets	puppets
temminckii	temminckii
alles	alles
zp	zp
sosa	sosa
glasgow	glasgow
gridcolor	gridcolor
darmstadt	darmstadt
caa	caa
designs	designs
jihad	jihad
stirling	stirling
welch	welch
bal	bal
dario	dario
xxiv	xxiv
monochrome	monochrome
calle	calle
dungeon	dungeon
biographie	biographie
smb	smb
blogspot	blogspot
hellenistic	hellenistic
improving	improving
itt	itt
oaks	oaks
mainsnak	mainsnak
gypsy	gypsy
debt	debt
après	après
jive	jive
dht	dht
viridis	viridis
worms	worms
threshold	threshold
bowman	bowman
dum	dum
nypd	nypd
sketches	sketches
vortex	vortex
knowing	knowing
rename	rename
wandering	wandering
utrecht	utrecht
tamias	tamias
olpc	olpc
nui	nui
venue	venue
freely	freely
obsession	obsession
albuquerque	albuquerque
lehmann	lehmann
drawings	drawings
officials	officials
bout	bout
dor	dor
ministers	ministers
unification	unification
easily	easily
caught	caught
xss	xss
halt	halt
trujillo	trujillo
россия	россия
opportunity	opportunity
dances	dances
kart	kart
regensburg	regensburg
adele	adele
singular	singular
unicef	unicef
banque	banque
orden	orden
mariano	mariano
esse	esse
bleeding	bleeding
commando	commando
eau	eau
boutique	boutique
gallagher	gallagher
iw	iw
ignore	ignore
overdrive	overdrive
fungi	fungi
spiegel	spiegel
caldwell	caldwell
gbs	gbs
brabant	brabant
alignbars	alignbars
carriers	carriers
clap	clap
édouard	édouard
identified	identified
adi	adi
dominus	dominus
puff	puff
alte	alte
dominion	dominion
spoken	spoken
kasumi	kasumi
usher	usher
fait	fait
midland	midland
abigail	abigail
région	région
kinase	kinase
oricon	oricon
journalist	journalist
scripting	scripting
nils	nils
lagenorhynchus	lagenorhynchus
botswana	botswana
cooke	cooke
mainstream	mainstream
infected	infected
cane	cane
k_i	k_i
vive	vive
és	és
grp	grp
beagle	beagle
tvxq	tvxq
firenze	firenze
ξ	ξ
bowie	bowie
clocks	clocks
recht	recht
conservatory	conservatory
tem	tem
elaphus	elaphus
officinalis	officinalis
showdown	showdown
molecules	molecules
lattice	lattice
sancti	sancti
cursor	cursor
labyrinth	labyrinth
dap	dap
bergman	bergman
ā	ā
bates	bates
alexa	alexa
paranoid	paranoid
leur	leur
armoiries	armoiries
elk	elk
audience	audience
kemp	kemp
gabriela	gabriela
på	på
starts	starts
plenty	plenty
kendall	kendall
citizenship	citizenship
armies	armies
countess	countess
bloc	bloc
maynard	maynard
designated	designated
investigations	investigations
mata	mata
silly	silly
cory	cory
normandie	normandie
notebook	notebook
turned	turned
speeches	speeches
chartvis	chartvis
cycles	cycles
ouest	ouest
muller	muller
lisboa	lisboa
lucien	lucien
flaming	flaming
gtr	gtr
lav	lav
socket	socket
gentle	gentle
vidal	vidal
traditions	traditions
dorsalis	dorsalis
drawn	drawn
bnf	bnf
afm	afm
ecstasy	ecstasy
interested	interested
forming	forming
_b	_b
counting	counting
haley	haley
toto	toto
playboy	playboy
dragonfly	dragonfly
d_i	d_i
battista	battista
outlaw	outlaw
ohne	ohne
tet	tet
fools	fools
sheridan	sheridan
svenska	svenska
faso	faso
wenn	wenn
soy	soy
conversations	conversations
seeking	seeking
occupational	occupational
controls	controls
carvalho	carvalho
leah	leah
gfp	gfp
cascade	cascade
flyer	flyer
steiner	steiner
everyman	everyman
avengers	avengers
elsa	elsa
icons	icons
ema	ema
gia	gia
jurassic	jurassic
dangerously	dangerously
procedures	procedures
germans	germans
transparency	transparency
gottlieb	gottlieb
paintings	paintings
reverend	reverend
sitting	sitting
bucket	bucket
broke	broke
biographies	biographies
fokker	fokker
ignorance	ignorance
elsewhere	elsewhere
greeks	greeks
wmap	wmap
محمد	محمد
cri	cri
humans	humans
dudley	dudley
centennial	centennial
cactus	cactus
insomnia	insomnia
verband	verband
algebraic	algebraic
alphonse	alphonse
thorn	thorn
racial	racial
nave	nave
mpaa	mpaa
hommes	hommes
gérard	gérard
nürnberg	nürnberg
loader	loader
athlon	athlon
ruben	ruben
nps	nps
burden	burden
decline	decline
strictly	strictly
treasury	treasury
anhalt	anhalt
naturally	naturally
zwischen	zwischen
gecko	gecko
studi	studi
dump	dump
constable	constable
castello	castello
rent	rent
beg	beg
presidents	presidents
россии	россии
periods	periods
disambig	disambig
gsg	gsg
neu	neu
britannia	britannia
camden	camden
fairchild	fairchild
duffy	duffy
turin	turin
agony	agony
quantity	quantity
nauru	nauru
considerations	considerations
busy	busy
tequila	tequila
frankfurter	frankfurter
władysław	władysław
undo	undo
household	household
arrest	arrest
romanum	romanum
discuss	discuss
ties	ties
marne	marne
ñ	ñ
kafka	kafka
hen	hen
packed	packed
votes	votes
polski	polski
republika	republika
monarch	monarch
unwin	unwin
keeper	keeper
moran	moran
wah	wah
kama	kama
più	più
wipo	wipo
peripheral	peripheral
kwk	kwk
mejor	mejor
drill	drill
dahlia	dahlia
leiocephalus	leiocephalus
toad	toad
todos	todos
d_n	d_n
eyewitness	eyewitness
moth	moth
engl	engl
galicia	galicia
caco	caco
babylonian	babylonian
sympathy	sympathy
scandinavian	scandinavian
dvr	dvr
willow	willow
hormone	hormone
vogel	vogel
circa	circa
supernatural	supernatural
geiger	geiger
attachment	attachment
warnings	warnings
trt	trt
drunk	drunk
morality	morality
générale	générale
mule	mule
ebu	ebu
cardiac	cardiac
boxstyle_	boxstyle_
garry	garry
schön	schön
oath	oath
outta	outta
cooling	cooling
hopes	hopes
pioneers	pioneers
lazarus	lazarus
agnus	agnus
byzantium	byzantium
nun	nun
rupert	rupert
bufo	bufo
bfi	bfi
lightblue	lightblue
cork	cork
sussex	sussex
raising	raising
rosemary	rosemary
ivf	ivf
lieder	lieder
glove	glove
sherwood	sherwood
dit	dit
être	être
microscope	microscope
breeding	breeding
termination	termination
unter	unter
mendel	mendel
víctor	víctor
potsdam	potsdam
lana	lana
cardiff	cardiff
yvonne	yvonne
pct	pct
photoshop	photoshop
gob	gob
wit	wit
huntington	huntington
cnrs	cnrs
álvaro	álvaro
continuity	continuity
tik	tik
addresses	addresses
zim	zim
florian	florian
silvestris	silvestris
kann	kann
scars	scars
ruin	ruin
mustard	mustard
fading	fading
wordpress	wordpress
prophets	prophets
francorum	francorum
barnett	barnett
icp	icp
iaa	iaa
rlc	rlc
micrixalus	micrixalus
persecution	persecution
neighborhood	neighborhood
closet	closet
tuberculosis	tuberculosis
remind	remind
renal	renal
tycoon	tycoon
diabetes	diabetes
ports	ports
prerogative	prerogative
hutton	hutton
belize	belize
mvc	mvc
toon	toon
coke	coke
harley	harley
könig	könig
emilia	emilia
ismail	ismail
stonewall	stonewall
flows	flows
victoire	victoire
highlighted	highlighted
luce	luce
gibb	gibb
absent	absent
_thinredsides	_thinredsides
artur	artur
ladder	ladder
synopsis	synopsis
concordia	concordia
persistence	persistence
domenico	domenico
discoveries	discoveries
cleopatra	cleopatra
indicus	indicus
restricted	restricted
fad	fad
sickness	sickness
morte	morte
nuestra	nuestra
klavier	klavier
woody	woody
sentinel	sentinel
cabin	cabin
contre	contre
elastic	elastic
estádio	estádio
zee	zee
tcm	tcm
dictionnaire	dictionnaire
sells	sells
enforcement	enforcement
bastard	bastard
gian	gian
eugenia	eugenia
isaiah	isaiah
focal	focal
deaf	deaf
bau	bau
