,	,
.	.
</s>	</s>
-	-
'	'
)	)
(	(
•	•
idt	idt
#	#
?	?
ist	ist
–	–
the	the
}	}
%	%
/	/
!	!
of	of
a	a
jpg	jpg
and	and
\	\
in	in
x	x
s	s
rd	rd
bgcolor	bgcolor
+	+
utc	utc
d	d
f	f
de	de
i	i
m	m
c	c
b	b
to	to
t	t
https	https
e	e
svg	svg
n	n
score	score
p	p
v	v
for	for
r	r
l	l
on	on
style	style
h	h
align	align
g	g
from	from
new	new
la	la
http	http
nba	nba
by	by
isbn	isbn
w	w
o	o
press	press
you	you
k	k
center	center
text	text
px	px
y	y
png	png
file	file
"	"
youtube	youtube
at	at
>	>
is	is
with	with
university	university
$	$
j	j
com	com
top	top
poly	poly
team	team
u	u
ori	ori
color	color
it	it
width	width
world	world
seed	seed
·	·
israel	israel
—	—
&	&
me	me
bar	bar
^	^
flag	flag
ii	ii
ω	ω
co	co
z	z
border	border
pp	pp
der	der
my	my
york	york
talk	talk
history	history
love	love
right	right
an	an
background	background
valign	valign
no	no
bbc	bbc
~	~
_	_
be	be
♥	♥
one	one
q	q
wikipedia	wikipedia
life	life
this	this
london	london
des	des
www	www
em	em
le	le
all	all
jewish	jewish
till	till
john	john
david	david
as	as
et	et
il	il
image	image
black	black
vol	vol
american	american
dna	dna
that	that
time	time
or	or
ed	ed
international	international
national	national
solid	solid
war	war
music	music
if	if
google	google
org	org
und	und
die	die
man	man
journal	journal
♠	♠
danny	danny
°	°
colspan	colspan
action	action
en	en
not	not
ffff	ffff
von	von
dvd	dvd
html	html
wikimedia	wikimedia
we	we
di	di
live	live
your	your
are	are
dc	dc
al	al
jerusalem	jerusalem
map	map
mt	mt
du	du
←	←
do	do
ff	ff
windows	windows
white	white
st	st
art	art
who	who
up	up
nrg	nrg
x_	x_
rowspan	rowspan
id	id
corvus	corvus
red	red
iii	iii
ffffff	ffffff
back	back
ben	ben
studies	studies
les	les
william	william
hot	hot
records	records
yes	yes
th	th
el	el
can	can
day	day
paris	paris
ip	ip
php	php
out	out
first	first
arm	arm
city	city
society	society
crystal	crystal
house	house
edition	edition
what	what
us	us
mvp	mvp
clear	clear
a_	a_
oxford	oxford
robert	robert
books	books
cambridge	cambridge
del	del
state	state
don	don
avi	avi
left	left
review	review
nhl	nhl
hebrew	hebrew
star	star
science	science
facebook	facebook
will	will
michael	michael
james	james
great	great
daniel	daniel
night	night
book	book
he	he
fa	fa
america	america
net	net
paul	paul
united	united
re	re
mtv	mtv
blue	blue
pdf	pdf
was	was
reference	reference
king	king
way	way
cia	cia
news	news
have	have
about	about
go	go
institute	institute
shift	shift
body	body
title	title
law	law
function	function
two	two
last	last
like	like
am	am
end	end
best	best
uk	uk
location	location
tour	tour
his	his
times	times
system	system
then	then
tv	tv
iv	iv
company	company
san	san
library	library
george	george
gov	gov
modern	modern
school	school
local	local
east	east
padding	padding
people	people
how	how
museum	museum
so	so
story	story
abc	abc
value	value
nd	nd
font	font
bot	bot
research	research
charles	charles
tau	tau
big	big
women	women
home	home
mit	mit
sports	sports
little	little
∞	∞
page	page
malone	malone
start	start
group	group
old	old
free	free
rock	rock
da	da
other	other
royal	royal
×	×
good	good
peter	peter
nf	nf
fbi	fbi
ibm	ibm
jews	jews
van	van
act	act
more	more
heart	heart
sa	sa
loc	loc
itf	itf
park	park
now	now
encyclopedia	encyclopedia
scope	scope
berlin	berlin
girl	girl
high	high
green	green
english	english
size	size
theory	theory
joseph	joseph
volume	volume
fontsize	fontsize
year	year
space	space
richard	richard
air	air
thomas	thomas
mr	mr
publishing	publishing
israeli	israeli
south	south
project	project
online	online
death	death
get	get
club	club
jean	jean
icd	icd
tel	tel
may	may
un	un
cd	cd
row	row
down	down
rna	rna
gray	gray
cbs	cbs
when	when
street	street
grand	grand
over	over
france	france
social	social
web	web
association	association
british	british
language	language
century	century
sts	sts
there	there
ac	ac
return	return
long	long
nbc	nbc
mw	mw
middle	middle
♦	♦
states	states
rect	rect
name	name
sir	sir
→	→
west	west
game	game
palestine	palestine
work	work
land	land
‎	‎
entertainment	entertainment
men	men
oh	oh
award	award
cc	cc
song	song
img	img
its	its
earth	earth
college	college
power	power
guide	guide
ma	ma
island	island
gif	gif
arms	arms
data	data
show	show
human	human
film	film
§	§
comics	comics
under	under
eds	eds
das	das
part	part
light	light
second	second
public	public
but	but
dictionary	dictionary
editor	editor
saint	saint
river	river
dead	dead
line	line
boy	boy
let	let
here	here
days	days
general	general
god	god
years	years
class	class
our	our
only	only
arts	arts
socks	socks
use	use
fm	fm
wwe	wwe
true	true
nfl	nfl
martin	martin
pattern_b	pattern_b
battle	battle
iso	iso
sea	sea
dark	dark
nc	nc
north	north
type	type
henry	henry
series	series
service	service
los	los
os	os
after	after
translated	translated
hill	hill
football	football
family	family
force	force
culture	culture
mac	mac
bc	bc
california	california
information	information
into	into
road	road
points	points
wordpress	wordpress
three	three
shorts	shorts
ch	ch
edited	edited
für	für
study	study
site	site
age	age
just	just
kiss	kiss
post	post
louis	louis
union	union
usa	usa
css	css
s_	s_
european	european
biography	biography
non	non
some	some
roman	roman
hall	hall
office	office
dream	dream
leftarrow	leftarrow
pages	pages
young	young
na	na
memorial	memorial
wiki	wiki
central	central
case	case
never	never
baby	baby
army	army
ancient	ancient
mako	mako
microsoft	microsoft
archive	archive
ne	ne
blood	blood
dance	dance
know	know
sun	sun
open	open
logo	logo
side	side
url	url
ph	ph
iucn	iucn
alexander	alexander
view	view
rotten	rotten
atp	atp
ca	ca
want	want
harvard	harvard
media	media
r_	r_
see	see
java	java
list	list
early	early
mark	mark
special	special
foundation	foundation
xxx	xxx
à	à
band	band
network	network
im	im
bottom	bottom
edward	edward
si	si
super	super
dr	dr
bridge	bridge
peace	peace
take	take
magazine	magazine
mp	mp
their	their
again	again
rex	rex
country	country
hd	hd
nature	nature
fire	fire
woman	woman
has	has
xbox	xbox
call	call
collection	collection
lost	lost
come	come
theatre	theatre
pattern_ra	pattern_ra
historical	historical
chicago	chicago
pattern_la	pattern_la
political	political
between	between
party	party
memory	memory
f_	f_
mi	mi
■	■
ogg	ogg
ep	ep
where	where
church	church
global	global
games	games
frank	frank
introduction	introduction
inc	inc
songs	songs
website	website
mod	mod
rc	rc
they	they
england	england
empire	empire
radio	radio
german	german
real	real
wall	wall
mind	mind
bad	bad
verlag	verlag
bb	bb
format	format
please	please
change	change
mary	mary
stars	stars
play	play
place	place
article	article
hbo	hbo
sur	sur
tu	tu
imdb	imdb
classical	classical
fox	fox
moon	moon
education	education
den	den
date	date
dos	dos
ios	ios
max	max
development	development
ss	ss
master	master
ein	ein
born	born
she	she
maria	maria
au	au
brown	brown
rgb	rgb
queen	queen
europe	europe
bd	bd
academy	academy
japan	japan
smith	smith
user	user
js	js
her	her
video	video
box	box
v_	v_
off	off
number	number
link	link
make	make
bg	bg
children	children
four	four
pc	pc
cohen	cohen
military	military
august	august
gb	gb
pl	pl
water	water
publishers	publishers
point	point
which	which
through	through
test	test
c_	c_
awards	awards
bf	bf
control	control
africa	africa
secret	secret
su	su
french	french
ie	ie
t_	t_
hdi	hdi
cat	cat
height	height
vi	vi
software	software
wild	wild
gold	gold
ltd	ltd
fall	fall
er	er
lake	lake
lady	lady
wta	wta
α	α
block	block
christian	christian
summer	summer
set	set
ll	ll
ab	ab
june	june
order	order
march	march
against	against
m_	m_
final	final
naval	naval
allmusic	allmusic
internet	internet
model	model
samuel	samuel
double	double
np	np
head	head
sky	sky
none	none
table	table
future	future
girls	girls
frame	frame
today	today
alt	alt
management	management
got	got
cross	cross
dl	dl
p_	p_
politics	politics
washington	washington
literature	literature
community	community
source	source
away	away
arthur	arthur
short	short
easy	easy
digital	digital
report	report
say	say
ad	ad
coat	coat
why	why
ncaa	ncaa
kingdom	kingdom
china	china
htm	htm
es	es
self	self
festival	festival
pictures	pictures
ba	ba
april	april
a_n	a_n
oy	oy
tower	tower
stories	stories
__notoc__	__notoc__
jr	jr
var	var
kg	kg
kf	kf
published	published
♣	♣
word	word
ve	ve
__noeditsection__	__noeditsection__
small	small
machine	machine
crazy	crazy
legend	legend
δ	δ
been	been
gt	gt
version	version
july	july
analysis	analysis
rca	rca
xx	xx
making	making
design	design
lee	lee
h_	h_
dsm	dsm
republic	republic
round	round
mls	mls
pro	pro
gps	gps
sex	sex
most	most
xp	xp
transfermarkt	transfermarkt
zur	zur
mount	mount
voice	voice
hiv	hiv
any	any
without	without
anti	anti
help	help
β	β
vertical	vertical
b_	b_
search	search
ray	ray
town	town
economic	economic
building	building
pierre	pierre
brill	brill
before	before
jack	jack
made	made
systems	systems
were	were
run	run
textcolor	textcolor
walter	walter
rose	rose
business	business
child	child
friedrich	friedrich
routledge	routledge
santa	santa
ira	ira
main	main
bay	bay
cnn	cnn
relief	relief
african	african
tr	tr
marie	marie
another	another
karl	karl
bank	bank
jones	jones
full	full
period	period
soul	soul
nt	nt
translation	translation
contemporary	contemporary
heaven	heaven
official	official
golden	golden
magic	magic
hans	hans
works	works
council	council
essays	essays
sound	sound
k_	k_
simon	simon
fi	fi
september	september
albert	albert
next	next
concacaf	concacaf
christmas	christmas
near	near
ta	ta
rise	rise
col	col
opera	opera
technology	technology
mediawiki	mediawiki
basketball	basketball
field	field
boys	boys
asp	asp
need	need
ra	ra
also	also
revolution	revolution
itunes	itunes
than	than
della	della
dj	dj
original	original
front	front
county	county
goose	goose
hell	hell
vs	vs
pa	pa
ds	ds
happy	happy
holocaust	holocaust
sciences	sciences
medical	medical
commons	commons
league	league
blues	blues
apple	apple
din	din
western	western
common	common
corporation	corporation
justice	justice
metal	metal
half	half
code	code
args	args
dx	dx
jacob	jacob
în	în
money	money
rf	rf
stone	stone
civil	civil
son	son
navy	navy
things	things
germany	germany
look	look
policy	policy
chess	chess
sr	sr
october	october
garden	garden
centre	centre
unit	unit
canada	canada
ct	ct
aa	aa
noon	noon
hard	hard
beyond	beyond
station	station
arab	arab
greatest	greatest
standard	standard
raw	raw
md	md
tree	tree
se	se
nation	nation
otrs	otrs
five	five
december	december
emi	emi
hotel	hotel
wilhelm	wilhelm
string	string
better	better
lord	lord
face	face
academic	academic
valley	valley
greek	greek
circle	circle
wars	wars
security	security
russian	russian
mg	mg
philosophy	philosophy
ipa	ipa
rights	rights
late	late
guy	guy
used	used
zoo	zoo
holy	holy
aus	aus
server	server
watch	watch
geschichte	geschichte
friends	friends
mother	mother
health	health
mountain	mountain
ru	ru
xs	xs
£	£
mk	mk
visual	visual
square	square
cultural	cultural
y_	y_
z_	z_
album	album
tales	tales
medal	medal
fr	fr
leo	leo
sin	sin
dog	dog
basic	basic
ice	ice
gnu	gnu
complete	complete
pattern_sh	pattern_sh
princeton	princeton
ms	ms
operation	operation
eyes	eyes
op	op
sweet	sweet
cgi	cgi
learning	learning
josé	josé
jan	jan
hms	hms
tell	tell
nothing	nothing
single	single
issue	issue
living	living
harry	harry
bravo	bravo
rb	rb
hello	hello
eye	eye
publications	publications
temple	temple
tom	tom
too	too
key	key
deep	deep
brothers	brothers
italy	italy
would	would
gallery	gallery
notes	notes
computer	computer
hits	hits
deutsche	deutsche
well	well
te	te
still	still
plus	plus
mgm	mgm
ted	ted
yellow	yellow
kids	kids
islands	islands
aspx	aspx
beautiful	beautiful
very	very
movie	movie
itv	itv
columbia	columbia
november	november
religion	religion
eastern	eastern
auto	auto
theater	theater
judaism	judaism
qd	qd
islam	islam
result	result
false	false
forever	forever
inside	inside
d_	d_
division	division
stephen	stephen
−	−
alpha	alpha
january	january
district	district
agg	agg
during	during
many	many
hand	hand
stop	stop
ah	ah
las	las
find	find
cm	cm
per	per
department	department
movement	movement
egypt	egypt
ngc	ngc
evolution	evolution
angel	angel
japanese	japanese
boston	boston
cry	cry
mb	mb
winter	winter
pt	pt
room	room
qc	qc
carl	carl
ea	ea
own	own
low	low
histoire	histoire
silver	silver
alfred	alfred
russia	russia
trade	trade
committee	committee
thing	thing
zu	zu
third	third
increment	increment
que	que
six	six
pbs	pbs
anthony	anthony
copy	copy
castle	castle
и	и
ke	ke
chapter	chapter
support	support
dem	dem
event	event
spirit	spirit
xml	xml
ich	ich
pattern_so	pattern_so
them	them
words	words
seven	seven
far	far
elizabeth	elizabeth
birds	birds
gfdl	gfdl
g_	g_
hollywood	hollywood
provincia	provincia
freedom	freedom
via	via
cell	cell
pop	pop
sm	sm
major	major
britain	britain
juan	juan
australia	australia
galaxy	galaxy
problem	problem
françois	françois
access	access
government	government
jazz	jazz
police	police
kh	kh
medicine	medicine
program	program
journey	journey
rsa	rsa
ar	ar
bible	bible
u_	u_
india	india
javascript	javascript
dei	dei
flight	flight
foreign	foreign
vii	vii
ltr	ltr
turn	turn
xor	xor
nfc	nfc
aim	aim
andrew	andrew
natural	natural
hp	hp
based	based
est	est
syndrome	syndrome
x_i	x_i
port	port
error	error
islamic	islamic
quarterly	quarterly
australian	australian
region	region
dan	dan
electronic	electronic
conference	conference
benjamin	benjamin
virtual	virtual
touch	touch
these	these
jane	jane
mode	mode
around	around
norman	norman
fda	fda
soccerway	soccerway
teams	teams
give	give
should	should
productions	productions
court	court
had	had
bill	bill
studio	studio
ny	ny
indian	indian
francisco	francisco
jacques	jacques
fort	fort
scientific	scientific
films	films
taylor	taylor
jpeg	jpeg
mass	mass
macmillan	macmillan
flickr	flickr
johann	johann
being	being
edit	edit
francis	francis
nb	nb
board	board
zone	zone
forest	forest
ju	ju
television	television
message	message
e_	e_
independent	independent
daily	daily
sc	sc
mobile	mobile
lives	lives
mri	mri
psychology	psychology
leiden	leiden
past	past
must	must
uss	uss
sql	sql
antonio	antonio
walk	walk
note	note
camp	camp
wii	wii
ign	ign
edge	edge
links	links
defense	defense
rome	rome
spring	spring
think	think
planet	planet
letters	letters
une	une
alan	alan
abraham	abraham
images	images
fussballdaten	fussballdaten
organization	organization
within	within
dir	dir
playstation	playstation
iron	iron
steven	steven
february	february
info	info
dans	dans
database	database
architecture	architecture
morning	morning
honor	honor
something	something
worldcat	worldcat
command	command
universal	universal
tonight	tonight
prince	prince
aba	aba
fe	fe
eco	eco
ring	ring
wind	wind
picture	picture
layer	layer
experience	experience
weight	weight
ap	ap
area	area
espn	espn
bell	bell
fantasy	fantasy
penguin	penguin
scott	scott
services	services
sio	sio
heinrich	heinrich
anne	anne
sd	sd
marker	marker
dame	dame
fiction	fiction
acid	acid
process	process
structure	structure
food	food
grove	grove
duty	duty
studios	studios
northern	northern
kill	kill
otto	otto
bold	bold
car	car
captain	captain
together	together
piano	piano
performance	performance
ex	ex
ball	ball
@	@
generation	generation
prize	prize
n_	n_
yale	yale
fn	fn
hero	hero
hope	hope
cold	cold
cool	cool
did	did
intelligence	intelligence
interview	interview
roll	roll
author	author
usb	usb
iphone	iphone
ng	ng
gnome	gnome
ou	ou
heroes	heroes
lexikon	lexikon
±	±
guitar	guitar
ram	ram
db	db
care	care
fair	fair
portrait	portrait
als	als
rs	rs
drive	drive
rpg	rpg
flying	flying
orchestra	orchestra
christopher	christopher
kd	kd
sp	sp
bernard	bernard
found	found
same	same
critical	critical
gone	gone
retrieved	retrieved
joe	joe
api	api
ce	ce
tal	tal
match	match
base	base
eric	eric
ernst	ernst
dreams	dreams
pacific	pacific
encyclopaedia	encyclopaedia
effect	effect
kb	kb
present	present
does	does
desert	desert
president	president
academia	academia
train	train
knight	knight
medieval	medieval
philip	philip
southern	southern
doctor	doctor
mrna	mrna
private	private
corps	corps
gay	gay
ctrl	ctrl
core	core
energy	energy
über	über
ps	ps
trust	trust
plan	plan
ann	ann
ieee	ieee
adam	adam
bird	bird
globe	globe
factor	factor
int	int
creative	creative
led	led
محمد	محمد
agm	agm
add	add
adventures	adventures
could	could
evil	evil
ak	ak
x_n	x_n
rain	rain
lc	lc
level	level
mort	mort
truth	truth
since	since
current	current
behind	behind
physics	physics
ship	ship
canadian	canadian
relations	relations
archaeology	archaeology
orange	orange
cup	cup
attack	attack
pink	pink
using	using
arabic	arabic
simple	simple
ha	ha
spider	spider
default	default
devil	devil
duke	duke
johnson	johnson
photo	photo
fifa	fifa
domain	domain
gordon	gordon
nintendo	nintendo
lawrence	lawrence
channel	channel
express	express
par	par
ka	ka
physical	physical
close	close
auf	auf
enterprise	enterprise
else	else
con	con
raf	raf
break	break
record	record
thought	thought
nations	nations
glass	glass
po	po
cs	cs
ghost	ghost
dell	dell
archives	archives
gott	gott
afc	afc
category	category
franz	franz
sydney	sydney
cw	cw
classic	classic
vod	vod
everything	everything
kc	kc
beach	beach
yahoo	yahoo
giovanni	giovanni
laugh	laugh
grande	grande
oil	oil
animal	animal
rh	rh
isaac	isaac
div	div
ok	ok
ag	ag
hold	hold
cathedral	cathedral
once	once
spanish	spanish
miss	miss
spain	spain
mars	mars
springer	springer
pour	pour
orientation	orientation
wien	wien
paper	paper
oc	oc
oriental	oriental
paradise	paradise
mad	mad
williams	williams
lp	lp
jonathan	jonathan
tag	tag
latin	latin
stage	stage
michel	michel
cartoon	cartoon
drama	drama
meeting	meeting
forces	forces
origins	origins
henri	henri
engineering	engineering
victor	victor
musical	musical
shadow	shadow
race	race
soviet	soviet
pre	pre
zealand	zealand
historia	historia
golf	golf
shall	shall
texas	texas
ludwig	ludwig
ivan	ivan
wide	wide
hearts	hearts
among	among
kind	kind
range	range
fc	fc
lewis	lewis
arena	arena
rio	rio
nh	nh
mario	mario
wi	wi
gate	gate
norton	norton
ten	ten
mm	mm
allen	allen
ook	ook
going	going
knowledge	knowledge
battlefield	battlefield
ace	ace
weekly	weekly
tough	tough
congress	congress
player	player
a_i	a_i
i_	i_
faith	faith
reason	reason
index	index
editors	editors
roger	roger
sv	sv
qb	qb
total	total
alone	alone
stand	stand
heritage	heritage
youth	youth
content	content
cinema	cinema
every	every
wwf	wwf
feel	feel
nacional	nacional
ever	ever
fine	fine
federation	federation
batman	batman
done	done
mathematics	mathematics
trans	trans
exploration	exploration
form	form
alliance	alliance
handbook	handbook
comedy	comedy
mo	mo
sam	sam
random	random
steel	steel
path	path
formation	formation
week	week
survey	survey
tnt	tnt
bruce	bruce
uefa	uefa
snow	snow
imperial	imperial
village	village
flash	flash
amsterdam	amsterdam
vie	vie
ride	ride
douglas	douglas
frederick	frederick
nowrap	nowrap
mission	mission
lsd	lsd
reich	reich
articles	articles
viii	viii
him	him
thank	thank
в	в
tma	tma
sunday	sunday
stanley	stanley
wnba	wnba
dawn	dawn
donald	donald
writing	writing
stanford	stanford
identity	identity
template	template
sub	sub
unix	unix
capital	capital
cut	cut
lower	lower
hey	hey
lion	lion
poetry	poetry
practice	practice
barbara	barbara
turkey	turkey
choice	choice
economics	economics
madrid	madrid
personal	personal
jordan	jordan
save	save
wolf	wolf
leipzig	leipzig
vapen	vapen
wehrmacht	wehrmacht
rev	rev
villa	villa
section	section
mhz	mhz
berkeley	berkeley
jesus	jesus
sms	sms
herbert	herbert
argentina	argentina
kv	kv
description	description
qf	qf
l_	l_
dies	dies
concert	concert
marvel	marvel
technical	technical
jackson	jackson
cover	cover
wilson	wilson
marine	marine
papers	papers
miller	miller
copyright	copyright
direction	direction
languages	languages
crown	crown
mexico	mexico
male	male
rg	rg
patrick	patrick
account	account
ucla	ucla
popular	popular
airport	airport
while	while
cl	cl
keep	keep
professor	professor
sha	sha
iran	iran
market	market
hat	hat
exchange	exchange
philadelphia	philadelphia
●	●
harper	harper
cos	cos
davis	davis
atlantic	atlantic
coming	coming
perfect	perfect
atlas	atlas
idf	idf
gun	gun
vision	vision
ultimate	ultimate
mountains	mountains
gil	gil
angeles	angeles
howard	howard
grave	grave
alice	alice
defence	defence
lines	lines
amd	amd
conflict	conflict
notre	notre
pass	pass
object	object
disease	disease
bulletin	bulletin
tony	tony
female	female
dragon	dragon
executive	executive
tomb	tomb
⊙	⊙
icon	icon
rainbow	rainbow
rebecca	rebecca
horse	horse
goodbye	goodbye
apollo	apollo
universe	universe
zero	zero
method	method
mystery	mystery
italian	italian
speed	speed
biblical	biblical
artist	artist
brain	brain
ain	ain
angry	angry
wood	wood
province	province
tradition	tradition
chinese	chinese
lonely	lonely
believe	believe
h_pattern_b	h_pattern_b
large	large
a_pattern_b	a_pattern_b
goes	goes
brian	brian
upright	upright
anna	anna
christ	christ
different	different
era	era
publisher	publisher
doi	doi
minor	minor
seal	seal
tokyo	tokyo
jstor	jstor
mc	mc
frankfurt	frankfurt
motion	motion
murder	murder
religious	religious
maps	maps
therapy	therapy
mail	mail
gender	gender
remember	remember
append	append
canyon	canyon
month	month
sg	sg
eu	eu
chief	chief
urban	urban
sony	sony
stadium	stadium
renaissance	renaissance
bass	bass
vh	vh
fly	fly
affairs	affairs
claude	claude
engine	engine
counter	counter
victoria	victoria
wish	wish
je	je
linux	linux
ruth	ruth
palace	palace
gabriel	gabriel
creek	creek
birthday	birthday
utf	utf
ipad	ipad
welcome	welcome
comes	comes
ghz	ghz
each	each
fame	fame
bear	bear
track	track
edu	edu
mein	mein
airliners	airliners
arsenal	arsenal
father	father
mine	mine
prime	prime
disney	disney
dd	dd
because	because
tomorrow	tomorrow
pd	pd
beatles	beatles
fish	fish
mirror	mirror
civilization	civilization
revised	revised
adventure	adventure
poems	poems
hermann	hermann
kings	kings
fade	fade
oecd	oecd
uv	uv
btr	btr
nova	nova
ya	ya
options	options
ireland	ireland
move	move
valve	valve
warfare	warfare
eine	eine
guns	guns
sas	sas
في	في
q_	q_
document	document
val	val
won	won
hospital	hospital
democracy	democracy
ipod	ipod
economy	economy
maurice	maurice
strike	strike
aircraft	aircraft
working	working
such	such
cern	cern
bfff	bfff
quest	quest
mix	mix
école	école
ready	ready
both	both
nr	nr
protocol	protocol
alive	alive
forum	forum
hour	hour
una	una
georg	georg
shot	shot
beat	beat
fear	fear
blank	blank
store	store
coast	coast
display	display
tm	tm
discovery	discovery
bit	bit
virgin	virgin
harold	harold
editions	editions
crisis	crisis
revue	revue
even	even
pan	pan
perspectives	perspectives
proceedings	proceedings
eagle	eagle
vip	vip
ion	ion
ns	ns
asia	asia
said	said
mathematical	mathematical
carlos	carlos
broken	broken
problems	problems
osprey	osprey
fat	fat
nine	nine
roses	roses
unreal	unreal
label	label
mlb	mlb
andré	andré
sing	sing
origin	origin
angels	angels
amor	amor
steve	steve
fight	fight
read	read
literary	literary
aux	aux
murray	murray
timeaxis	timeaxis
question	question
upon	upon
wave	wave
pub	pub
cn	cn
bros	bros
written	written
guardian	guardian
lang	lang
xy	xy
arnold	arnold
check	check
homo	homo
lights	lights
selected	selected
always	always
nil	nil
lcd	lcd
fields	fields
much	much
letter	letter
bt	bt
sons	sons
diamond	diamond
plotarea	plotarea
amazing	amazing
season	season
phone	phone
ix	ix
stern	stern
available	available
sign	sign
scalemajor	scalemajor
chris	chris
indiana	indiana
tiger	tiger
mini	mini
wiley	wiley
hit	hit
gmail	gmail
print	print
nuclear	nuclear
commission	commission
rising	rising
put	put
lo	lo
mediterranean	mediterranean
advanced	advanced
gr	gr
str	str
warner	warner
purple	purple
animals	animals
ascii	ascii
midnight	midnight
spd	spd
vols	vols
li	li
door	door
symphony	symphony
cu	cu
xi	xi
sarah	sarah
beta	beta
rom	rom
sport	sport
dt	dt
iraq	iraq
grace	grace
patch	patch
legacy	legacy
glory	glory
monte	monte
gm	gm
ariel	ariel
labor	labor
scale	scale
tim	tim
request	request
mike	mike
pm	pm
electric	electric
teatro	teatro
imagesize	imagesize
associated	associated
uri	uri
challenge	challenge
palazzo	palazzo
texts	texts
bush	bush
blu	blu
quake	quake
behavior	behavior
cemetery	cemetery
mcgraw	mcgraw
approach	approach
independence	independence
bild	bild
oblast	oblast
variation	variation
manuel	manuel
casa	casa
price	price
neue	neue
amx	amx
moore	moore
française	française
role	role
syria	syria
moscow	moscow
agency	agency
called	called
principles	principles
georgia	georgia
legal	legal
br	br
johnny	johnny
silence	silence
nmc	nmc
nana	nana
punk	punk
sexual	sexual
vienna	vienna
strange	strange
centered	centered
pas	pas
broadway	broadway
tor	tor
click	click
forward	forward
samsung	samsung
bh	bh
ocean	ocean
operations	operations
ja	ja
ward	ward
fast	fast
billboard	billboard
h_shorts	h_shorts
species	species
bus	bus
companion	companion
toronto	toronto
liberty	liberty
looking	looking
reader	reader
teen	teen
skin	skin
changes	changes
ian	ian
moses	moses
ee	ee
empty	empty
win	win
kate	kate
sonic	sonic
person	person
steam	steam
friend	friend
doc	doc
paperback	paperback
tears	tears
step	step
fund	fund
aj	aj
abbey	abbey
xl	xl
av	av
h_body	h_body
giant	giant
accessed	accessed
photography	photography
julius	julius
π	π
hi	hi
lev	lev
application	application
rue	rue
chemical	chemical
nasa	nasa
va	va
campaign	campaign
limited	limited
treaty	treaty
assassin	assassin
wine	wine
secrets	secrets
bmw	bmw
tech	tech
leave	leave
ensign	ensign
ernest	ernest
equus	equus
bob	bob
rules	rules
publication	publication
ghetto	ghetto
comparative	comparative
avenue	avenue
communication	communication
friday	friday
adult	adult
manual	manual
pet	pet
log	log
ref	ref
lui	lui
annual	annual
perspective	perspective
screen	screen
raymond	raymond
commentary	commentary
rfc	rfc
institut	institut
profile	profile
ro	ro
circus	circus
symbol	symbol
münchen	münchen
vida	vida
zum	zum
wings	wings
those	those
production	production
tank	tank
lane	lane
monster	monster
iww	iww
biology	biology
speak	speak
georges	georges
ts	ts
storm	storm
programming	programming
networks	networks
active	active
director	director
complex	complex
trouble	trouble
cape	cape
wappen	wappen
ground	ground
sleep	sleep
ε	ε
app	app
worlds	worlds
span	span
chemistry	chemistry
ottoman	ottoman
creed	creed
deutsches	deutsches
robin	robin
commander	commander
qa	qa
theodor	theodor
reality	reality
travel	travel
…	…
mercury	mercury
thanks	thanks
is_set	is_set
adolf	adolf
lie	lie
lot	lot
harris	harris
geo	geo
phase	phase
count	count
res	res
wrong	wrong
dom	dom
leon	leon
communications	communications
solomon	solomon
voyage	voyage
baa	baa
vista	vista
alignbars	alignbars
miles	miles
federal	federal
kenneth	kenneth
leonard	leonard
josef	josef
reading	reading
financial	financial
fighting	fighting
numbers	numbers
rule	rule
acm	acm
coli	coli
johannes	johannes
stay	stay
trial	trial
parameter	parameter
response	response
transfer	transfer
matter	matter
math	math
wanna	wanna
budapest	budapest
growth	growth
blind	blind
nicholas	nicholas
episode	episode
masters	masters
birth	birth
mann	mann
hands	hands
anderson	anderson
fx	fx
jim	jim
target	target
margaret	margaret
colorado	colorado
combat	combat
anthology	anthology
bi	bi
interactive	interactive
member	member
mrs	mrs
gridcolor	gridcolor
others	others
nice	nice
études	études
terror	terror
sources	sources
wcw	wcw
novel	novel
higher	higher
marc	marc
wayne	wayne
ibn	ibn
baron	baron
matthew	matthew
monument	monument
egyptian	egyptian
locator	locator
files	files
nights	nights
explorer	explorer
multi	multi
window	window
genesis	genesis
tab	tab
ronald	ronald
darkness	darkness
purpose	purpose
infinite	infinite
pr	pr
tool	tool
nsa	nsa
hu	hu
jersey	jersey
heat	heat
dec	dec
ron	ron
enemy	enemy
gonna	gonna
roma	roma
são	são
virginia	virginia
module	module
terra	terra
prix	prix
node	node
million	million
geology	geology
csi	csi
h_pattern_s	h_pattern_s
update	update
users	users
marcus	marcus
npov	npov
haven	haven
leben	leben
walker	walker
convention	convention
industrial	industrial
impact	impact
с	с
tgv	tgv
الله	الله
o_	o_
meet	meet
cells	cells
reprinted	reprinted
heavy	heavy
unknown	unknown
bundesarchiv	bundesarchiv
suite	suite
fun	fun
rich	rich
mare	mare
flow	flow
vote	vote
cook	cook
roy	roy
susan	susan
industry	industry
aviation	aviation
avec	avec
dateformat	dateformat
berger	berger
allan	allan
lg	lg
justin	justin
joint	joint
speech	speech
possible	possible
rss	rss
quantum	quantum
irish	irish
ustring	ustring
beer	beer
dancing	dancing
construction	construction
crime	crime
grey	grey
railway	railway
ni	ni
pmid	pmid
jeffrey	jeffrey
monde	monde
nl	nl
princess	princess
margin	margin
mar	mar
opening	opening
nov	nov
beauty	beauty
jew	jew
romania	romania
nach	nach
illustrated	illustrated
script	script
educational	educational
robinson	robinson
wb	wb
gsm	gsm
pi	pi
coa	coa
a_pattern_s	a_pattern_s
advance	advance
jay	jay
minutes	minutes
anonymous	anonymous
irc	irc
memories	memories
γ	γ
greece	greece
write	write
ai	ai
carter	carter
classics	classics
waiting	waiting
tale	tale
administration	administration
abu	abu
qui	qui
fighter	fighter
gothic	gothic
oliver	oliver
mineral	mineral
writings	writings
orient	orient
collins	collins
chronicle	chronicle
details	details
release	release
username	username
franklin	franklin
sense	sense
earl	earl
sacred	sacred
including	including
katz	katz
myspace	myspace
dirty	dirty
soldier	soldier
feature	feature
cap	cap
lead	lead
virus	virus
course	course
por	por
projects	projects
ape	ape
wanted	wanted
jeff	jeff
bring	bring
mon	mon
bandera	bandera
hub	hub
andreas	andreas
framework	framework
funk	funk
until	until
logic	logic
gary	gary
commonwealth	commonwealth
brother	brother
applications	applications
ethiopia	ethiopia
wonder	wonder
andrea	andrea
å	å
enter	enter
gpl	gpl
brazil	brazil
firefox	firefox
ethics	ethics
bone	bone
missing	missing
squadron	squadron
basin	basin
a_body	a_body
a_shorts	a_shorts
yourself	yourself
carlo	carlo
joshua	joshua
delta	delta
above	above
interior	interior
med	med
authority	authority
romance	romance
victory	victory
felix	felix
rest	rest
vincent	vincent
directory	directory
θ	θ
evidence	evidence
joan	joan
underground	underground
ask	ask
ib	ib
length	length
ci	ci
bis	bis
manager	manager
collected	collected
iq	iq
nm	nm
piece	piece
dear	dear
rp	rp
groups	groups
hunter	hunter
ralph	ralph
disorder	disorder
marshall	marshall
arte	arte
lan	lan
ages	ages
later	later
movies	movies
moment	moment
hudson	hudson
idea	idea
pac	pac
epic	epic
expedition	expedition
try	try
éditions	éditions
justify	justify
deutschen	deutschen
femme	femme
whole	whole
ville	ville
ultra	ultra
pretty	pretty
insert	insert
malta	malta
across	across
upper	upper
might	might
pain	pain
really	really
w_	w_
regional	regional
vom	vom
barry	barry
artists	artists
meaning	meaning
italia	italia
cancer	cancer
ge	ge
character	character
weapons	weapons
cf	cf
michigan	michigan
musicians	musicians
kde	kde
floor	floor
known	known
audio	audio
panthera	panthera
everybody	everybody
vice	vice
ideas	ideas
alex	alex
cuisine	cuisine
prayer	prayer
lat	lat
shell	shell
kevin	kevin
evening	evening
solo	solo
barcelona	barcelona
elements	elements
ross	ross
clark	clark
recordings	recordings
beginning	beginning
config	config
rsssf	rsssf
wa	wa
fischer	fischer
fortune	fortune
ford	ford
sierra	sierra
perl	perl
mba	mba
mama	mama
satellite	satellite
aes	aes
teenage	teenage
fbc	fbc
reform	reform
enough	enough
nicht	nicht
android	android
eugene	eugene
status	status
osi	osi
property	property
kid	kid
wales	wales
struggle	struggle
luis	luis
sci	sci
treatment	treatment
europa	europa
silent	silent
someone	someone
uh	uh
ladies	ladies
grant	grant
related	related
um	um
wake	wake
wright	wright
pattern	pattern
folk	folk
archaeological	archaeological
russell	russell
arkive	arkive
hidden	hidden
takes	takes
professional	professional
gates	gates
feminist	feminist
fortress	fortress
wing	wing
mitchell	mitchell
jump	jump
levy	levy
testing	testing
netherlands	netherlands
cas	cas
rtl	rtl
aires	aires
alternative	alternative
applied	applied
einer	einer
population	population
kfz	kfz
burning	burning
killer	killer
rudolf	rudolf
fashion	fashion
gal	gal
pedro	pedro
bang	bang
famous	famous
gods	gods
cloud	cloud
codex	codex
fritz	fritz
para	para
viva	viva
extreme	extreme
owl	owl
swing	swing
context	context
internal	internal
chamber	chamber
reflections	reflections
werner	werner
buenos	buenos
session	session
halo	halo
société	société
multiple	multiple
myth	myth
nme	nme
milano	milano
arc	arc
ftp	ftp
risk	risk
gadget	gadget
parameters	parameters
oclc	oclc
amour	amour
beast	beast
essay	essay
direct	direct
sword	sword
klein	klein
ga	ga
b_i	b_i
↔	↔
homme	homme
values	values
singer	singer
mean	mean
echo	echo
phoenix	phoenix
costa	costa
trek	trek
hunt	hunt
stuart	stuart
francesco	francesco
f_n	f_n
ken	ken
gas	gas
fuck	fuck
rolling	rolling
mental	mental
erich	erich
theme	theme
ec	ec
hitler	hitler
ships	ships
msn	msn
amir	amir
ir	ir
pol	pol
hdtv	hdtv
raid	raid
dsc	dsc
training	training
poker	poker
claims	claims
lies	lies
austria	austria
illinois	illinois
cr	cr
welt	welt
passion	passion
cbc	cbc
sorry	sorry
rocket	rocket
laboratory	laboratory
vita	vita
honey	honey
canal	canal
bid	bid
bw	bw
holiday	holiday
remix	remix
twenty	twenty
anton	anton
fantastic	fantastic
eight	eight
ferdinand	ferdinand
somebody	somebody
min	min
hungary	hungary
shadows	shadows
distribution	distribution
hamilton	hamilton
etc	etc
avengers	avengers
diary	diary
nicolas	nicolas
nbl	nbl
means	means
britannica	britannica
français	français
a_k	a_k
jason	jason
ti	ti
tie	tie
sage	sage
jimmy	jimmy
integration	integration
rko	rko
buffalo	buffalo
smile	smile
riaa	riaa
trail	trail
straight	straight
lucky	lucky
marcel	marcel
nelson	nelson
twentieth	twentieth
spy	spy
horizontal	horizontal
bmp	bmp
tunnel	tunnel
warren	warren
memoirs	memoirs
inner	inner
yo	yo
card	card
deutschland	deutschland
gustav	gustav
saturday	saturday
stress	stress
ipv	ipv
flower	flower
mx	mx
drop	drop
pg	pg
p_i	p_i
muslim	muslim
diego	diego
elephant	elephant
collapse	collapse
creation	creation
elseif	elseif
bureau	bureau
root	root
external	external
hate	hate
bulgaria	bulgaria
falling	falling
ia	ia
brief	brief
sh	sh
due	due
nationale	nationale
methods	methods
yyyy	yyyy
carolina	carolina
maría	maría
hammer	hammer
pcr	pcr
following	following
visualeditor	visualeditor
sessions	sessions
summary	summary
ribbon	ribbon
voices	voices
geforce	geforce
bomb	bomb
airlines	airlines
diamonds	diamonds
kelly	kelly
thompson	thompson
stuttgart	stuttgart
translate	translate
bo	bo
morris	morris
fool	fool
bat	bat
leader	leader
poland	poland
dana	dana
escape	escape
sugar	sugar
material	material
qt	qt
documents	documents
resources	resources
conservation	conservation
elle	elle
rafael	rafael
internationale	internationale
hart	hart
carol	carol
rachel	rachel
sites	sites
charlie	charlie
gene	gene
hugh	hugh
questions	questions
hills	hills
effects	effects
example	example
autobiography	autobiography
museo	museo
infinity	infinity
names	names
sister	sister
environment	environment
resource	resource
edwin	edwin
j_	j_
lt	lt
soa	soa
feeling	feeling
dogs	dogs
dust	dust
caf	caf
championship	championship
walking	walking
savage	savage
issn	issn
gesellschaft	gesellschaft
cropped	cropped
criminal	criminal
protein	protein
rosa	rosa
mask	mask
understanding	understanding
evans	evans
lincoln	lincoln
kennedy	kennedy
cairo	cairo
philippe	philippe
stewart	stewart
pennsylvania	pennsylvania
mid	mid
parker	parker
naked	naked
python	python
graham	graham
на	на
camera	camera
warrior	warrior
chance	chance
doom	doom
factory	factory
emperor	emperor
levi	levi
salt	salt
sap	sap
delle	delle
citation	citation
bach	bach
meyer	meyer
maritime	maritime
alain	alain
b_n	b_n
success	success
shake	shake
knopf	knopf
xiii	xiii
cost	cost
dutch	dutch
gan	gan
interface	interface
россии	россии
lloyd	lloyd
crash	crash
imax	imax
pinus	pinus
rhythm	rhythm
address	address
zeit	zeit
detective	detective
guerre	guerre
vb	vb
running	running
chrome	chrome
bull	bull
monkey	monkey
greater	greater
invisible	invisible
slave	slave
strong	strong
primary	primary
plaza	plaza
cv	cv
yesterday	yesterday
solution	solution
wesley	wesley
scaleminor	scaleminor
precision	precision
recent	recent
kurt	kurt
rush	rush
ninja	ninja
select	select
singles	singles
zeitschrift	zeitschrift
decision	decision
protection	protection
killing	killing
pure	pure
interwiki	interwiki
thin	thin
sant	sant
chain	chain
parade	parade
forgotten	forgotten
loves	loves
reverse	reverse
shine	shine
_p	_p
cycle	cycle
intel	intel
het	het
dangerous	dangerous
cave	cave
belle	belle
affair	affair
standing	standing
ol	ol
gran	gran
contact	contact
kong	kong
hatched	hatched
mir	mir
soft	soft
eli	eli
safety	safety
baker	baker
denis	denis
axis	axis
miguel	miguel
towards	towards
½	½
rate	rate
aspects	aspects
oscar	oscar
says	says
asian	asian
grid	grid
technologies	technologies
computing	computing
guild	guild
eva	eva
legends	legends
lightgrey	lightgrey
brigade	brigade
ali	ali
liebe	liebe
cba	cba
jet	jet
boat	boat
came	came
potter	potter
quality	quality
slow	slow
zion	zion
edinburgh	edinburgh
sos	sos
theodore	theodore
warsaw	warsaw
clarendon	clarendon
amazon	amazon
progress	progress
chronicles	chronicles
larry	larry
highway	highway
scotland	scotland
vhs	vhs
kim	kim
ethiopian	ethiopian
kitchen	kitchen
minister	minister
clinical	clinical
apache	apache
catch	catch
trio	trio
falls	falls
hamburg	hamburg
pictogram	pictogram
hrsg	hrsg
writers	writers
af	af
rt	rt
reserve	reserve
comic	comic
reporter	reporter
musik	musik
schools	schools
burn	burn
limit	limit
glam	glam
thames	thames
htc	htc
eclipse	eclipse
augustus	augustus
agent	agent
bon	bon
duck	duck
sega	sega
holland	holland
makes	makes
talking	talking
nobody	nobody
apps	apps
superman	superman
crew	crew
cities	cities
eden	eden
pe	pe
lantern	lantern
porta	porta
gap	gap
lb	lb
resistance	resistance
campbell	campbell
mojo	mojo
conmebol	conmebol
officer	officer
fred	fred
blackwell	blackwell
properties	properties
qg	qg
hours	hours
parts	parts
giuseppe	giuseppe
writer	writer
qh	qh
dam	dam
given	given
wilderness	wilderness
nathan	nathan
florida	florida
xii	xii
lhc	lhc
tb	tb
dying	dying
rivers	rivers
follow	follow
arabia	arabia
dynamic	dynamic
interpretation	interpretation
destruction	destruction
aug	aug
fourth	fourth
administrative	administrative
helen	helen
ae	ae
philosophical	philosophical
deutscher	deutscher
sounds	sounds
transport	transport
outside	outside
siècle	siècle
issues	issues
phd	phd
cooper	cooper
morgan	morgan
vu	vu
oct	oct
capitol	capitol
nexus	nexus
chapel	chapel
det	det
fifth	fifth
leaders	leaders
olympic	olympic
midi	midi
animation	animation
daughter	daughter
geological	geological
biographical	biographical
madonna	madonna
assembly	assembly
bruno	bruno
remove	remove
laws	laws
sociology	sociology
junior	junior
prof	prof
ic	ic
deal	deal
†	†
positive	positive
tools	tools
armenian	armenian
sec	sec
authors	authors
td	td
manchester	manchester
arch	arch
rem	rem
genocide	genocide
presents	presents
ml	ml
dynamics	dynamics
iss	iss
lab	lab
emil	emil
ua	ua
alien	alien
tha	tha
cp	cp
sk	sk
pocket	pocket
plays	plays
s_i	s_i
wife	wife
belong	belong
oracle	oracle
sweden	sweden
experimental	experimental
swift	swift
taken	taken
shakespeare	shakespeare
surface	surface
faces	faces
gets	gets
exhibition	exhibition
job	job
ft	ft
personality	personality
berliner	berliner
uses	uses
vocals	vocals
cnt	cnt
hl	hl
focus	focus
bones	bones
hole	hole
definition	definition
tube	tube
peak	peak
venus	venus
ratio	ratio
ajax	ajax
joel	joel
catholic	catholic
documentary	documentary
ax	ax
thousand	thousand
volumes	volumes
wolfgang	wolfgang
psychological	psychological
lovers	lovers
€	€
ho	ho
flowers	flowers
viking	viking
corpus	corpus
lightning	lightning
bsd	bsd
oder	oder
hr	hr
native	native
dennis	dennis
universität	universität
geography	geography
places	places
palais	palais
xxxx	xxxx
floyd	floyd
normal	normal
frozen	frozen
bmi	bmi
playing	playing
xv	xv
term	term
orion	orion
wallace	wallace
create	create
void	void
tcp	tcp
divisions	divisions
gang	gang
pen	pen
colors	colors
models	models
petit	petit
twilight	twilight
nazi	nazi
entity	entity
liberation	liberation
dune	dune
contributions	contributions
chile	chile
adobe	adobe
blog	blog
mer	mer
breaking	breaking
piazza	piazza
miracle	miracle
bronze	bronze
divine	divine
button	button
bloody	bloody
roi	roi
adhd	adhd
nick	nick
freddie	freddie
lea	lea
bei	bei
pieces	pieces
gta	gta
fact	fact
degli	degli
narrative	narrative
wie	wie
capra	capra
klm	klm
shop	shop
aaron	aaron
seine	seine
foot	foot
thinking	thinking
selection	selection
survival	survival
turner	turner
amg	amg
destiny	destiny
pb	pb
marriage	marriage
brand	brand
nih	nih
nvidia	nvidia
billy	billy
iaaf	iaaf
bug	bug
getting	getting
soon	soon
portal	portal
entry	entry
sharon	sharon
clock	clock
wired	wired
forms	forms
fallen	fallen
oz	oz
product	product
strategy	strategy
az	az
luigi	luigi
messages	messages
according	according
antoine	antoine
sculpture	sculpture
scream	scream
hair	hair
beck	beck
lfsr	lfsr
sn	sn
yet	yet
khan	khan
v_i	v_i
resolution	resolution
ned	ned
loving	loving
phillips	phillips
anniversary	anniversary
loud	loud
austin	austin
marco	marco
several	several
sans	sans
liber	liber
photographs	photographs
farm	farm
gs	gs
subject	subject
pressure	pressure
bdsm	bdsm
adrian	adrian
split	split
outline	outline
nord	nord
canis	canis
meta	meta
julia	julia
answers	answers
position	position
revenge	revenge
autumn	autumn
myself	myself
leopold	leopold
eternal	eternal
dh	dh
canvas	canvas
almost	almost
soldiers	soldiers
pearl	pearl
medium	medium
fw	fw
louise	louise
nu	nu
korea	korea
_whitesides	_whitesides
château	château
knows	knows
alberto	alberto
created	created
fever	fever
capo	capo
license	license
aol	aol
signal	signal
paulo	paulo
sul	sul
gilbert	gilbert
rescue	rescue
psp	psp
planning	planning
iris	iris
editing	editing
statistics	statistics
bright	bright
è	è
nancy	nancy
newton	newton
telegraph	telegraph
student	student
jam	jam
vt	vt
historic	historic
pepper	pepper
patterns	patterns
ellis	ellis
arizona	arizona
avg	avg
lettres	lettres
ob	ob
premier	premier
deux	deux
mai	mai
persian	persian
diff	diff
johan	johan
oss	oss
branch	branch
italiana	italiana
along	along
vehicle	vehicle
pietro	pietro
cb	cb
pos	pos
share	share
views	views
ev	ev
stranger	stranger
concept	concept
wmf	wmf
millennium	millennium
cream	cream
nationalism	nationalism
stock	stock
aerial	aerial
pal	pal
tribute	tribute
pie	pie
km	km
less	less
suicide	suicide
herman	herman
forget	forget
route	route
ryan	ryan
wrestling	wrestling
trends	trends
dover	dover
godfather	godfather
lifetime	lifetime
eve	eve
boom	boom
polish	polish
λ	λ
tragedy	tragedy
plain	plain
mn	mn
moving	moving
recording	recording
load	load
ln	ln
students	students
wmflabs	wmflabs
turkish	turkish
s_n	s_n
lock	lock
met	met
lte	lte
jules	jules
discussion	discussion
deutsch	deutsch
wiener	wiener
secure	secure
dv	dv
sudan	sudan
greenwood	greenwood
taking	taking
oak	oak
phantom	phantom
hong	hong
nos	nos
м	м
wikidata	wikidata
cite	cite
plc	plc
cornell	cornell
jennifer	jennifer
photos	photos
strategic	strategic
ut	ut
guard	guard
edgar	edgar
memoir	memoir
twa	twa
gregory	gregory
dick	dick
bodies	bodies
temps	temps
brave	brave
chef	chef
launch	launch
humanities	humanities
negative	negative
<	<
gift	gift
roots	roots
chair	chair
smart	smart
mundo	mundo
wait	wait
ways	ways
adams	adams
crossing	crossing
amy	amy
tilde	tilde
critics	critics
sim	sim
fin	fin
palgrave	palgrave
keith	keith
events	events
»	»
britney	britney
metropolitan	metropolitan
rx	rx
isle	isle
dich	dich
frontier	frontier
join	join
bin	bin
workers	workers
celebration	celebration
horror	horror
functions	functions
calling	calling
recovery	recovery
fan	fan
moi	moi
colour	colour
varanus	varanus
fleet	fleet
mma	mma
molecular	molecular
joy	joy
lamb	lamb
features	features
rank	rank
trna	trna
acc	acc
nouvelle	nouvelle
majesty	majesty
fruit	fruit
houston	houston
micro	micro
alert	alert
atr	atr
ant	ant
scientist	scientist
essential	essential
ridge	ridge
emblem	emblem
département	département
musique	musique
inter	inter
lover	lover
changing	changing
already	already
sunshine	sunshine
influence	influence
harrison	harrison
bye	bye
esther	esther
ldl	ldl
drug	drug
matrix	matrix
rocks	rocks
legion	legion
connection	connection
ukraine	ukraine
environmental	environmental
countries	countries
mig	mig
float	float
robot	robot
chase	chase
tournament	tournament
exit	exit
exe	exe
element	element
gob	gob
criticism	criticism
df	df
cfa	cfa
milan	milan
ld	ld
ana	ana
edits	edits
genius	genius
celtic	celtic
salon	salon
supreme	supreme
unplugged	unplugged
sadie	sadie
jerry	jerry
σ	σ
null	null
variety	variety
collective	collective
saints	saints
important	important
judith	judith
dp	dp
gloria	gloria
ruby	ruby
wizard	wizard
ext	ext
soundtrack	soundtrack
shock	shock
toward	toward
bed	bed
desc	desc
reprint	reprint
malcolm	malcolm
democratic	democratic
mysql	mysql
jon	jon
za	za
task	task
io	io
accounts	accounts
sings	sings
bow	bow
pairs	pairs
warning	warning
terminal	terminal
lorenzo	lorenzo
moral	moral
push	push
violence	violence
dave	dave
lebanon	lebanon
tea	tea
alba	alba
settlement	settlement
showtime	showtime
colony	colony
μ	μ
extra	extra
sebastian	sebastian
distance	distance
caesar	caesar
infobox	infobox
magnus	magnus
thor	thor
helix	helix
bm	bm
principle	principle
hay	hay
charlotte	charlotte
monitor	monitor
sus	sus
а	а
venice	venice
bibliography	bibliography
mim	mim
argument	argument
xiv	xiv
flags	flags
ins	ins
hugo	hugo
superior	superior
rider	rider
gsub	gsub
listen	listen
españa	españa
chart	chart
annie	annie
linear	linear
vous	vous
harmony	harmony
sein	sein
chaos	chaos
goal	goal
americans	americans
u_i	u_i
disorders	disorders
shaw	shaw
admiral	admiral
cache	cache
christianity	christianity
territory	territory
ov	ov
afl	afl
ends	ends
templates	templates
miami	miami
crt	crt
fernando	fernando
mozilla	mozilla
input	input
teaching	teaching
colombia	colombia
по	по
worldwide	worldwide
comment	comment
maker	maker
honour	honour
usgs	usgs
anatomy	anatomy
horizon	horizon
rené	rené
antiquity	antiquity
fref	fref
stein	stein
babel	babel
ui	ui
regiment	regiment
seen	seen
doubleday	doubleday
obe	obe
weekend	weekend
acts	acts
geoffrey	geoffrey
harvey	harvey
nor	nor
nad	nad
norway	norway
acoustic	acoustic
constitution	constitution
silva	silva
scene	scene
seasons	seasons
sgt	sgt
prefix	prefix
من	من
colin	colin
lecture	lecture
gp	gp
ek	ek
hear	hear
elite	elite
cruz	cruz
distinguished	distinguished
baptist	baptist
safe	safe
adler	adler
mechanics	mechanics
portugal	portugal
perseus	perseus
balance	balance
bmg	bmg
lithuania	lithuania
julian	julian
terre	terre
pv	pv
unita	unita
doe	doe
demi	demi
monastery	monastery
statistical	statistical
trilogy	trilogy
materials	materials
cellspacing	cellspacing
alla	alla
reviews	reviews
cause	cause
holding	holding
pci	pci
returns	returns
cdu	cdu
baltimore	baltimore
landscape	landscape
illusion	illusion
mont	mont
operator	operator
jp	jp
imagine	imagine
erp	erp
aid	aid
che	che
changed	changed
bp	bp
m_i	m_i
processing	processing
rage	rage
voip	voip
iihf	iihf
amc	amc
peoples	peoples
eat	eat
madness	madness
apr	apr
schuster	schuster
ara	ara
transition	transition
dinosaur	dinosaur
jude	jude
faculty	faculty
bloom	bloom
detroit	detroit
monsters	monsters
pound	pound
labour	labour
monday	monday
leadership	leadership
lieutenant	lieutenant
gazella	gazella
passage	passage
anthropology	anthropology
fix	fix
lose	lose
trip	trip
catherine	catherine
revisited	revisited
gear	gear
minute	minute
gross	gross
centuries	centuries
outlook	outlook
wonderful	wonderful
barra	barra
inscription	inscription
winning	winning
wants	wants
bet	bet
ppi	ppi
yf	yf
lectures	lectures
scheme	scheme
updated	updated
seds	seds
wisdom	wisdom
plot	plot
jm	jm
unified	unified
sol	sol
mythology	mythology
itu	itu
solar	solar
seventh	seventh
elisabeth	elisabeth
mixed	mixed
automatic	automatic
stefan	stefan
manhattan	manhattan
pack	pack
nightmare	nightmare
desire	desire
laura	laura
kz	kz
elsevier	elsevier
begin	begin
pdp	pdp
atom	atom
musée	musée
bitch	bitch
cum	cum
ccd	ccd
thunder	thunder
antarctic	antarctic
ddr	ddr
heights	heights
gbu	gbu
radar	radar
suit	suit
panic	panic
zeppelin	zeppelin
messenger	messenger
rough	rough
workshop	workshop
below	below
butterfly	butterfly
diversity	diversity
plant	plant
woods	woods
testament	testament
ww	ww
kn	kn
tcm	tcm
atomic	atomic
turtles	turtles
wir	wir
twisted	twisted
rare	rare
auguste	auguste
okh	okh
various	various
funny	funny
poor	poor
о	о
txt	txt
volcano	volcano
reign	reign
zip	zip
sat	sat
ago	ago
needs	needs
cognitive	cognitive
hip	hip
versus	versus
spin	spin
election	election
wheel	wheel
flame	flame
paolo	paolo
bobby	bobby
lucy	lucy
roberto	roberto
babylon	babylon
meine	meine
sand	sand
anything	anything
colonial	colonial
negro	negro
dome	dome
eazy	eazy
catalogue	catalogue
hannah	hannah
noise	noise
kick	kick
crusades	crusades
campus	campus
sous	sous
liberal	liberal
apg	apg
remixes	remixes
massachusetts	massachusetts
naples	naples
danger	danger
flagge	flagge
oral	oral
stripes	stripes
anas	anas
eduard	eduard
proof	proof
rr	rr
corner	corner
uns	uns
pioneer	pioneer
boot	boot
hood	hood
mouth	mouth
kunst	kunst
few	few
rad	rad
jeremy	jeremy
schmidt	schmidt
depression	depression
printing	printing
sight	sight
notice	notice
gardens	gardens
violin	violin
timothy	timothy
tribune	tribune
cage	cage
thriller	thriller
monuments	monuments
ensemble	ensemble
baptiste	baptiste
remains	remains
terms	terms
stones	stones
maximus	maximus
ohio	ohio
fresh	fresh
falco	falco
gc	gc
mouse	mouse
least	least
painting	painting
nz	nz
alexandre	alexandre
tata	tata
aria	aria
iupac	iupac
ku	ku
ave	ave
lupus	lupus
istanbul	istanbul
hopkins	hopkins
ethernet	ethernet
aka	aka
loop	loop
fu	fu
marx	marx
comte	comte
smash	smash
happiness	happiness
jakob	jakob
siege	siege
reports	reports
characters	characters
soccer	soccer
wire	wire
compact	compact
pablo	pablo
query	query
societies	societies
ufc	ufc
dns	dns
extended	extended
reprise	reprise
stadt	stadt
prentice	prentice
bishop	bishop
poet	poet
tail	tail
ser	ser
bristol	bristol
landau	landau
miriam	miriam
utah	utah
streets	streets
bowen	bowen
studien	studien
dynasty	dynasty
brooklyn	brooklyn
gustave	gustave
bahn	bahn
rrna	rrna
downtown	downtown
kaplan	kaplan
specific	specific
dy	dy
vladimir	vladimir
ethnic	ethnic
lay	lay
unter	unter
edmund	edmund
abs	abs
александр	александр
florence	florence
noaa	noaa
emanuel	emanuel
c_i	c_i
tonumber	tonumber
motor	motor
prevention	prevention
fate	fate
boulder	boulder
taste	taste
radical	radical
hellenistic	hellenistic
sud	sud
dorothy	dorothy
sl	sl
lynx	lynx
wildlife	wildlife
maison	maison
weather	weather
café	café
organizational	organizational
prague	prague
blow	blow
centro	centro
mercy	mercy
magnetic	magnetic
sachsen	sachsen
anglo	anglo
minnesota	minnesota
carry	carry
fal	fal
spot	spot
cats	cats
ciudad	ciudad
smb	smb
array	array
herald	herald
knew	knew
airways	airways
commerce	commerce
nj	nj
def	def
contract	contract
saw	saw
nes	nes
arp	arp
smoke	smoke
torre	torre
twelve	twelve
sisters	sisters
holt	holt
hughes	hughes
eugen	eugen
staff	staff
perry	perry
santiago	santiago
statue	statue
belt	belt
build	build
dialog	dialog
composer	composer
fl	fl
hawk	hawk
holmes	holmes
incredible	incredible
jungle	jungle
gerald	gerald
candy	candy
abuse	abuse
geographic	geographic
agreement	agreement
limits	limits
warcraft	warcraft
transformation	transformation
champion	champion
cox	cox
faber	faber
lied	lied
oregon	oregon
hundred	hundred
soc	soc
sharing	sharing
c_n	c_n
académie	académie
psi	psi
facts	facts
scholar	scholar
xd	xd
nas	nas
ncis	ncis
tommy	tommy
cake	cake
nat	nat
requiem	requiem
members	members
hungarian	hungarian
lisboa	lisboa
ki	ki
vulpes	vulpes
papa	papa
xvi	xvi
scholars	scholars
marina	marina
naacp	naacp
progressive	progressive
feet	feet
rq	rq
missile	missile
monthly	monthly
loved	loved
brick	brick
deer	deer
indonesia	indonesia
bryan	bryan
reed	reed
pool	pool
waltz	waltz
errors	errors
mca	mca
ß	ß
released	released
quick	quick
broadcasting	broadcasting
blake	blake
conquest	conquest
gaba	gaba
optical	optical
powers	powers
panorama	panorama
harbor	harbor
erik	erik
acth	acth
ashes	ashes
emily	emily
friedman	friedman
quartet	quartet
item	item
chronic	chronic
inn	inn
travels	travels
chip	chip
joachim	joachim
conrad	conrad
trois	trois
syrian	syrian
scenes	scenes
lodge	lodge
areas	areas
jorge	jorge
gto	gto
exile	exile
nk	nk
cherry	cherry
detail	detail
freud	freud
wise	wise
munich	munich
plate	plate
kansas	kansas
h_n	h_n
download	download
further	further
parallel	parallel
interest	interest
luna	luna
rebel	rebel
switch	switch
drums	drums
platform	platform
houses	houses
fk	fk
bath	bath
musica	musica
regina	regina
vivo	vivo
spiritual	spiritual
cbe	cbe
mayer	mayer
visions	visions
miranda	miranda
fountain	fountain
milk	milk
tanks	tanks
massacre	massacre
baden	baden
output	output
nn	nn
simpson	simpson
sabbath	sabbath
moderne	moderne
answer	answer
carnival	carnival
hc	hc
former	former
secretary	secretary
aureus	aureus
atv	atv
cable	cable
dry	dry
ritual	ritual
grade	grade
neo	neo
og	og
eines	eines
lisa	lisa
contribution	contribution
leslie	leslie
eta	eta
grammar	grammar
martha	martha
kent	kent
standards	standards
named	named
pgm	pgm
quarter	quarter
nx	nx
tennis	tennis
blast	blast
andy	andy
livre	livre
muscle	muscle
intellectual	intellectual
ur	ur
waves	waves
nun	nun
ministry	ministry
φ	φ
comprehensive	comprehensive
terry	terry
rap	rap
maybe	maybe
lópez	lópez
odyssey	odyssey
{	{
lockheed	lockheed
summit	summit
sniper	sniper
spencer	spencer
sad	sad
wifi	wifi
unicode	unicode
boris	boris
adp	adp
guinea	guinea
sussex	sussex
ans	ans
ghosts	ghosts
disk	disk
salvador	salvador
eb	eb
elias	elias
filter	filter
mesa	mesa
pulse	pulse
bullet	bullet
keys	keys
enigma	enigma
carrier	carrier
mutant	mutant
jfk	jfk
roland	roland
dean	dean
schwartz	schwartz
rick	rick
roberts	roberts
om	om
len	len
pride	pride
jquery	jquery
ssl	ssl
beth	beth
és	és
libre	libre
zürich	zürich
foundations	foundations
guest	guest
atlanta	atlanta
mlrs	mlrs
lands	lands
amore	amore
glenn	glenn
emmanuel	emmanuel
saturn	saturn
république	république
editorial	editorial
maryland	maryland
hide	hide
loss	loss
byte	byte
butler	butler
dm	dm
types	types
sometimes	sometimes
consciousness	consciousness
horn	horn
knights	knights
biological	biological
opinion	opinion
mhc	mhc
phys	phys
ye	ye
trap	trap
clarke	clarke
option	option
rubin	rubin
hg	hg
deu	deu
basilica	basilica
practical	practical
biographie	biographie
sale	sale
feedback	feedback
caroline	caroline
ada	ada
cars	cars
landing	landing
hcl	hcl
includes	includes
tar	tar
elegans	elegans
seas	seas
however	however
hs	hs
communities	communities
latex	latex
pic	pic
lesbian	lesbian
aero	aero
bowl	bowl
vietnam	vietnam
fixed	fixed
madison	madison
orthodox	orthodox
singapore	singapore
loader	loader
pw	pw
happened	happened
results	results
permission	permission
bel	bel
cgs	cgs
visit	visit
representation	representation
vegas	vegas
meat	meat
patricia	patricia
snake	snake
turning	turning
panzer	panzer
belgium	belgium
lotus	lotus
organisation	organisation
linda	linda
broadcast	broadcast
ppm	ppm
île	île
rouge	rouge
ihr	ihr
klaus	klaus
saudi	saudi
pay	pay
_thinwhitesides	_thinwhitesides
palm	palm
tt	tt
r_i	r_i
dimension	dimension
arrow	arrow
activity	activity
invasion	invasion
prototype	prototype
observer	observer
infantry	infantry
emergency	emergency
deus	deus
dll	dll
twin	twin
daddy	daddy
cultures	cultures
interaction	interaction
saul	saul
shape	shape
neil	neil
capensis	capensis
guillaume	guillaume
patrol	patrol
accessdate	accessdate
individual	individual
wang	wang
pursuit	pursuit
bella	bella
bound	bound
boulevard	boulevard
contains	contains
commercial	commercial
wet	wet
ao	ao
experiment	experiment
avant	avant
dress	dress
finland	finland
restaurant	restaurant
qwerty	qwerty
collaboration	collaboration
buildings	buildings
maximilian	maximilian
closer	closer
bradley	bradley
overview	overview
icao	icao
mosaic	mosaic
register	register
npr	npr
cafe	cafe
glen	glen
emergence	emergence
talks	talks
impossible	impossible
traditional	traditional
velvet	velvet
condition	condition
schneider	schneider
histories	histories
bio	bio
ones	ones
oro	oro
roc	roc
alright	alright
theoretical	theoretical
jtm	jtm
transmission	transmission
lv	lv
gulf	gulf
gateway	gateway
hockey	hockey
kit	kit
trinity	trinity
yours	yours
anc	anc
acta	acta
moritz	moritz
discourse	discourse
aids	aids
rename	rename
amos	amos
rifle	rifle
revival	revival
prison	prison
haute	haute
victorian	victorian
f_i	f_i
structures	structures
poster	poster
magna	magna
anchor	anchor
switzerland	switzerland
util	util
mv	mv
cole	cole
goldberg	goldberg
lh	lh
vevo	vevo
rings	rings
macy	macy
exclusive	exclusive
sure	sure
wedding	wedding
aig	aig
doesn	doesn
berg	berg
unique	unique
survivor	survivor
petersburg	petersburg
ursus	ursus
owen	owen
cast	cast
critique	critique
ops	ops
dissertation	dissertation
lynn	lynn
frances	frances
allgemeine	allgemeine
revolver	revolver
warszawa	warszawa
competition	competition
bridges	bridges
denmark	denmark
müller	müller
doing	doing
stockholm	stockholm
yemen	yemen
cortex	cortex
wisconsin	wisconsin
pine	pine
bn	bn
ais	ais
vector	vector
theological	theological
ze	ze
rabbit	rabbit
och	och
cva	cva
skull	skull
ras	ras
killed	killed
instead	instead
nasl	nasl
column	column
tf	tf
nerve	nerve
decade	decade
southwest	southwest
rj	rj
cornelius	cornelius
assault	assault
rothschild	rothschild
thoughts	thoughts
staphylococcus	staphylococcus
ef	ef
drugs	drugs
umbrella	umbrella
dual	dual
cases	cases
mathematica	mathematica
sainte	sainte
graf	graf
concepts	concepts
banner	banner
duo	duo
rhapsody	rhapsody
fia	fia
regular	regular
valentine	valentine
either	either
powell	powell
seymour	seymour
mag	mag
foo	foo
exist	exist
strauss	strauss
reflection	reflection
tables	tables
units	units
chen	chen
mich	mich
assessment	assessment
unity	unity
pair	pair
sys	sys
η	η
ansi	ansi
eo	eo
animated	animated
everyone	everyone
valle	valle
partido	partido
torpedo	torpedo
worst	worst
fellow	fellow
entre	entre
sum	sum
whale	whale
melbourne	melbourne
demo	demo
ei	ei
racing	racing
k_b	k_b
dea	dea
imagination	imagination
roth	roth
heinz	heinz
having	having
euro	euro
montreal	montreal
header	header
trees	trees
watson	watson
qu	qu
strangers	strangers
hal	hal
corporate	corporate
trick	trick
objects	objects
dz	dz
tl	tl
venezuela	venezuela
clay	clay
drm	drm
levin	levin
ark	ark
labs	labs
walls	walls
dallas	dallas
clean	clean
ordre	ordre
hop	hop
lac	lac
sei	sei
gravity	gravity
guerra	guerra
leia	leia
variable	variable
caption	caption
jung	jung
κ	κ
excel	excel
hsbc	hsbc
ecology	ecology
bars	bars
rms	rms
garcía	garcía
llc	llc
maximum	maximum
simbad	simbad
wicked	wicked
strength	strength
zoom	zoom
cbd	cbd
whatever	whatever
metro	metro
kaiser	kaiser
teacher	teacher
johns	johns
rai	rai
lr	lr
translations	translations
lizard	lizard
champions	champions
beethoven	beethoven
pak	pak
prima	prima
saga	saga
judas	judas
alessandro	alessandro
parliament	parliament
hz	hz
fis	fis
tango	tango
maya	maya
zee	zee
tracks	tracks
eyed	eyed
triple	triple
jefferson	jefferson
namespace	namespace
socialist	socialist
diana	diana
sort	sort
remote	remote
bottle	bottle
estado	estado
ballad	ballad
pq	pq
innovation	innovation
portable	portable
claire	claire
processes	processes
evaluation	evaluation
shield	shield
leaves	leaves
lz	lz
mighty	mighty
freebsd	freebsd
voting	voting
cites	cites
rogue	rogue
obituary	obituary
geometry	geometry
sleeping	sleeping
stronger	stronger
figure	figure
vera	vera
aw	aw
structural	structural
edith	edith
julie	julie
philipp	philipp
köln	köln
static	static
thy	thy
lyon	lyon
sequence	sequence
capture	capture
gi	gi
noble	noble
ams	ams
ellen	ellen
worth	worth
turtle	turtle
reach	reach
vax	vax
ntv	ntv
players	players
inline	inline
parque	parque
rice	rice
submarine	submarine
esc	esc
menu	menu
joão	joão
université	université
references	references
sacrifice	sacrifice
gutenberg	gutenberg
ups	ups
tactical	tactical
nuit	nuit
bond	bond
blanc	blanc
colonel	colonel
fury	fury
bs	bs
redemption	redemption
algebra	algebra
nist	nist
sunset	sunset
murphy	murphy
lyrics	lyrics
nyc	nyc
chi	chi
weiss	weiss
jupiter	jupiter
held	held
lateral	lateral
encounter	encounter
mmm	mmm
featuring	featuring
somewhere	somewhere
feminism	feminism
merry	merry
printed	printed
host	host
vic	vic
odd	odd
leading	leading
n_i	n_i
messier	messier
sara	sara
drum	drum
revolutionary	revolutionary
email	email
luke	luke
soap	soap
countdown	countdown
subscription	subscription
plateau	plateau
coffee	coffee
armed	armed
wikisource	wikisource
soil	soil
tna	tna
mayor	mayor
graphic	graphic
wikis	wikis
andre	andre
childhood	childhood
dollar	dollar
added	added
dove	dove
carbon	carbon
américa	américa
pig	pig
alle	alle
diseases	diseases
tc	tc
christine	christine
plants	plants
melody	melody
hawaii	hawaii
tax	tax
gentleman	gentleman
yi	yi
slam	slam
constant	constant
dot	dot
wonderland	wonderland
computers	computers
▪	▪
relationship	relationship
fur	fur
ecm	ecm
gpa	gpa
karen	karen
luck	luck
cms	cms
ill	ill
kk	kk
required	required
giorgio	giorgio
igf	igf
elder	elder
bern	bern
haus	haus
shark	shark
gerhard	gerhard
sf	sf
churchill	churchill
jessica	jessica
junction	junction
sexy	sexy
shoot	shoot
bag	bag
mile	mile
koch	koch
flesh	flesh
ponte	ponte
architectural	architectural
pony	pony
cooking	cooking
gh	gh
surgery	surgery
laser	laser
raphael	raphael
bride	bride
craig	craig
arctic	arctic
polar	polar
aaa	aaa
gale	gale
souls	souls
winner	winner
cz	cz
dio	dio
difference	difference
pascal	pascal
alma	alma
presentation	presentation
tribe	tribe
told	told
gotta	gotta
thesis	thesis
dictionnaire	dictionnaire
mil	mil
paula	paula
janet	janet
ritter	ritter
swan	swan
secondary	secondary
platinum	platinum
theorem	theorem
prefecture	prefecture
sz	sz
leonardo	leonardo
christoph	christoph
pkk	pkk
hook	hook
reconstruction	reconstruction
arpanet	arpanet
hubert	hubert
institution	institution
rey	rey
traditions	traditions
rat	rat
ay	ay
supplement	supplement
brotherhood	brotherhood
able	able
replace	replace
isn	isn
freeman	freeman
akademie	akademie
sb	sb
mpeg	mpeg
fb	fb
delete	delete
teu	teu
built	built
fig	fig
career	career
mu	mu
alabama	alabama
blogspot	blogspot
piper	piper
º	º
flat	flat
sis	sis
earliest	earliest
darpa	darpa
organ	organ
telephone	telephone
gl	gl
confessions	confessions
alphabet	alphabet
gorilla	gorilla
agriculture	agriculture
bandeira	bandeira
elena	elena
fearless	fearless
puerto	puerto
speaking	speaking
actor	actor
addison	addison
nobel	nobel
strings	strings
sally	sally
talent	talent
arguments	arguments
lessons	lessons
sonata	sonata
paz	paz
mate	mate
pont	pont
mosque	mosque
iranian	iranian
cid	cid
muhammad	muhammad
versions	versions
dedicated	dedicated
clouds	clouds
ism	ism
berry	berry
jerome	jerome
otherwise	otherwise
sidney	sidney
lovely	lovely
fairy	fairy
borough	borough
institutions	institutions
ema	ema
seconds	seconds
stream	stream
hurt	hurt
signs	signs
wagner	wagner
mor	mor
orientalis	orientalis
comments	comments
eugène	eugène
fit	fit
blade	blade
allegro	allegro
revolt	revolt
mia	mia
disc	disc
pitch	pitch
sick	sick
gmbh	gmbh
factors	factors
industries	industries
deb	deb
como	como
nowhere	nowhere
willem	willem
identification	identification
device	device
eddie	eddie
meets	meets
understand	understand
heads	heads
bios	bios
anthem	anthem
foster	foster
rather	rather
penny	penny
barnes	barnes
titans	titans
risc	risc
pat	pat
tan	tan
triumph	triumph
univ	univ
entrance	entrance
bae	bae
recognition	recognition
sanctuary	sanctuary
kramer	kramer
lucas	lucas
annals	annals
fra	fra
badge	badge
sar	sar
franco	franco
jacobs	jacobs
expanded	expanded
angelo	angelo
pilot	pilot
implications	implications
expression	expression
outer	outer
gist	gist
río	río
originally	originally
mickey	mickey
engineers	engineers
pete	pete
organizations	organizations
luca	luca
calendar	calendar
directx	directx
mercedes	mercedes
semi	semi
shore	shore
gen	gen
leopard	leopard
dram	dram
farewell	farewell
til	til
declaration	declaration
artificial	artificial
abel	abel
initiative	initiative
integrated	integrated
wow	wow
mater	mater
witch	witch
©	©
triangle	triangle
levels	levels
cooperation	cooperation
mq	mq
awake	awake
graduate	graduate
premium	premium
peer	peer
enix	enix
liquid	liquid
signature	signature
chant	chant
liverpool	liverpool
deborah	deborah
controller	controller
dolls	dolls
pov	pov
moments	moments
ssh	ssh
weapon	weapon
wo	wo
deadly	deadly
grass	grass
freak	freak
tk	tk
loose	loose
santo	santo
hardcover	hardcover
acting	acting
conditions	conditions
wikitable	wikitable
erwin	erwin
darling	darling
mundi	mundi
lm	lm
become	become
canton	canton
algorithm	algorithm
tac	tac
antony	antony
christina	christina
helmut	helmut
mustela	mustela
santana	santana
certain	certain
mills	mills
celebrity	celebrity
jpl	jpl
nam	nam
delhi	delhi
chan	chan
maple	maple
este	este
situation	situation
hybrid	hybrid
australis	australis
glacier	glacier
insurance	insurance
swedish	swedish
judge	judge
wireless	wireless
aix	aix
postscript	postscript
cleveland	cleveland
bean	bean
compton	compton
ulrich	ulrich
treasure	treasure
matters	matters
han	han
fatale	fatale
swimming	swimming
zfc	zfc
families	families
porto	porto
dale	dale
orlando	orlando
waters	waters
x_k	x_k
emma	emma
basel	basel
console	console
ofk	ofk
newman	newman
fisher	fisher
drawing	drawing
nur	nur
ost	ost
feat	feat
clash	clash
rodríguez	rodríguez
stupid	stupid
bee	bee
roads	roads
moves	moves
naca	naca
penn	penn
bmx	bmx
félix	félix
duncan	duncan
mill	mill
insignia	insignia
concerto	concerto
durch	durch
gli	gli
client	client
sides	sides
folklore	folklore
chelsea	chelsea
challenges	challenges
vocal	vocal
harp	harp
swiss	swiss
credit	credit
strip	strip
wu	wu
pakistan	pakistan
py	py
mechanical	mechanical
empires	empires
physiology	physiology
differential	differential
feb	feb
czech	czech
senate	senate
electronics	electronics
sands	sands
cotton	cotton
diaries	diaries
darwin	darwin
valid	valid
fluid	fluid
clown	clown
niger	niger
rebellion	rebellion
fff	fff
charts	charts
priest	priest
rosen	rosen
opengl	opengl
burns	burns
chicken	chicken
todd	todd
merit	merit
flora	flora
setting	setting
jar	jar
augusta	augusta
transactions	transactions
marble	marble
jonas	jonas
xm	xm
lords	lords
atm	atm
ash	ash
hf	hf
deck	deck
distributed	distributed
bac	bac
moa	moa
mbps	mbps
parent	parent
dieu	dieu
drink	drink
bernhard	bernhard
browning	browning
finance	finance
bonn	bonn
stuff	stuff
sharp	sharp
anyone	anyone
noir	noir
petite	petite
rubber	rubber
bbs	bbs
ezra	ezra
fdl	fdl
damn	damn
kay	kay
sullivan	sullivan
performed	performed
municipal	municipal
brasil	brasil
pope	pope
morrison	morrison
jun	jun
shi	shi
endless	endless
hdr	hdr
domestic	domestic
transaction	transaction
milton	milton
parc	parc
stack	stack
rfid	rfid
gimme	gimme
ego	ego
correspondence	correspondence
nowiki	nowiki
davies	davies
antarctica	antarctica
edmond	edmond
oriented	oriented
montgomery	montgomery
storia	storia
radiation	radiation
contest	contest
einstein	einstein
xxi	xxi
adsl	adsl
needed	needed
exodus	exodus
katherine	katherine
walt	walt
udp	udp
luther	luther
victims	victims
fifty	fifty
vogue	vogue
cash	cash
isla	isla
usp	usp
discography	discography
spaces	spaces
iis	iis
uci	uci
spice	spice
defeat	defeat
acre	acre
portland	portland
laurence	laurence
immortal	immortal
jenny	jenny
xhtml	xhtml
kentucky	kentucky
verde	verde
albany	albany
deprecated	deprecated
santos	santos
y_i	y_i
rockstar	rockstar
ending	ending
define	define
lucius	lucius
riot	riot
betty	betty
boxstyle_	boxstyle_
rm	rm
alejandro	alejandro
mas	mas
doors	doors
kai	kai
ο	ο
nouveau	nouveau
bpm	bpm
programme	programme
gtx	gtx
iowa	iowa
send	send
byzantine	byzantine
pit	pit
nazionale	nazionale
xix	xix
helena	helena
sultan	sultan
alaska	alaska
operating	operating
pvc	pvc
schwarz	schwarz
pale	pale
houghton	houghton
sbs	sbs
frequency	frequency
bafta	bafta
cookie	cookie
heidelberg	heidelberg
ballet	ballet
bloch	bloch
asin	asin
gardner	gardner
wells	wells
ding	ding
finding	finding
demon	demon
sherman	sherman
matt	matt
alarm	alarm
grow	grow
harpercollins	harpercollins
__	__
kx	kx
storage	storage
chateau	chateau
nel	nel
crater	crater
slim	slim
tout	tout
serial	serial
león	león
corp	corp
apocalypse	apocalypse
khz	khz
rim	rim
graves	graves
currently	currently
pays	pays
chez	chez
abstract	abstract
vicente	vicente
edwards	edwards
forty	forty
pueblo	pueblo
favorite	favorite
cooh	cooh
transparent	transparent
philosophie	philosophie
regulation	regulation
gazette	gazette
monsieur	monsieur
webelements	webelements
const	const
michelle	michelle
buy	buy
singing	singing
rocky	rocky
ls	ls
driver	driver
vampire	vampire
funeral	funeral
twist	twist
athens	athens
railroad	railroad
chocolate	chocolate
radeon	radeon
citizens	citizens
electron	electron
tx	tx
teachers	teachers
encyclopædia	encyclopædia
lra	lra
oops	oops
felis	felis
emotion	emotion
battery	battery
classification	classification
governor	governor
chat	chat
hare	hare
ht	ht
albrecht	albrecht
artery	artery
started	started
jt	jt
eh	eh
tall	tall
scottish	scottish
caribbean	caribbean
invention	invention
dhcp	dhcp
cephalophus	cephalophus
panda	panda
suzanne	suzanne
plane	plane
palmer	palmer
toy	toy
libraries	libraries
stella	stella
ella	ella
sobre	sobre
phalacrocorax	phalacrocorax
vc	vc
frost	frost
traffic	traffic
techniques	techniques
navigation	navigation
putnam	putnam
dor	dor
ami	ami
citizen	citizen
shanghai	shanghai
trauma	trauma
eternity	eternity
ticket	ticket
migration	migration
catedral	catedral
pleasure	pleasure
throne	throne
temptation	temptation
gibson	gibson
cx	cx
peta	peta
incident	incident
resort	resort
selling	selling
charge	charge
hirsch	hirsch
saguinus	saguinus
cdc	cdc
genetta	genetta
mons	mons
xvii	xvii
products	products
cervus	cervus
fault	fault
plastic	plastic
alvin	alvin
instituto	instituto
legendary	legendary
bois	bois
ws	ws
porter	porter
awakening	awakening
enlightenment	enlightenment
videos	videos
lopez	lopez
kenya	kenya
desktop	desktop
noel	noel
topographic	topographic
elisa	elisa
ban	ban
slide	slide
weber	weber
delivery	delivery
sept	sept
república	república
girlfriend	girlfriend
napoleon	napoleon
afraid	afraid
functional	functional
learn	learn
k_i	k_i
pick	pick
ubuntu	ubuntu
puzzle	puzzle
rob	rob
arbor	arbor
christians	christians
nebraska	nebraska
absolute	absolute
photographic	photographic
dialogue	dialogue
facing	facing
uncle	uncle
dreaming	dreaming
marks	marks
coins	coins
astronomy	astronomy
drei	drei
bachelor	bachelor
ips	ips
я	я
promise	promise
г	г
perrin	perrin
___	___
ses	ses
potential	potential
occupation	occupation
aurora	aurora
bennett	bennett
photograph	photograph
dim	dim
strawberry	strawberry
smaller	smaller
pace	pace
athlon	athlon
solutions	solutions
psycho	psycho
comparison	comparison
stan	stan
abroad	abroad
ü	ü
lions	lions
x_j	x_j
lux	lux
conspiracy	conspiracy
sunrise	sunrise
armstrong	armstrong
steps	steps
acute	acute
dvb	dvb
shows	shows
nyu	nyu
jesse	jesse
crying	crying
religions	religions
formula	formula
ξ	ξ
zwischen	zwischen
prophet	prophet
elementary	elementary
linked	linked
presidential	presidential
isa	isa
norwegian	norwegian
dublin	dublin
climate	climate
obama	obama
aces	aces
citizenship	citizenship
thomson	thomson
kahn	kahn
investigation	investigation
neu	neu
cannot	cannot
noah	noah
baroque	baroque
paint	paint
strait	strait
theories	theories
dramatic	dramatic
sls	sls
mafia	mafia
shoes	shoes
fletcher	fletcher
cg	cg
fps	fps
landmark	landmark
mpla	mpla
springs	springs
technique	technique
preservation	preservation
tres	tres
tissue	tissue
stamp	stamp
disaster	disaster
continuum	continuum
rand	rand
carmen	carmen
theology	theology
vpn	vpn
didn	didn
doctrine	doctrine
conway	conway
montana	montana
serious	serious
crimes	crimes
whom	whom
anno	anno
estate	estate
leaf	leaf
parks	parks
hannibal	hannibal
seattle	seattle
italiano	italiano
portraits	portraits
claim	claim
bologna	bologna
irving	irving
boogie	boogie
pin	pin
rapid	rapid
vulgaris	vulgaris
sw	sw
plans	plans
panther	panther
و	و
squad	squad
documentation	documentation
quiet	quiet
warm	warm
bears	bears
peters	peters
martín	martín
crane	crane
sorrow	sorrow
violet	violet
sail	sail
codes	codes
carroll	carroll
rogers	rogers
americana	americana
inferior	inferior
fusion	fusion
coral	coral
harcourt	harcourt
utopia	utopia
igg	igg
alter	alter
moonlight	moonlight
sylvia	sylvia
apa	apa
aeg	aeg
sins	sins
concise	concise
token	token
fellowship	fellowship
photographer	photographer
receptor	receptor
egg	egg
yves	yves
lovin	lovin
ars	ars
graph	graph
veil	veil
include	include
nacl	nacl
produced	produced
diagram	diagram
presented	presented
shut	shut
winston	winston
asa	asa
demand	demand
num	num
romantic	romantic
к	к
clinton	clinton
draft	draft
greg	greg
xo	xo
homer	homer
complexity	complexity
associates	associates
protected	protected
compilation	compilation
sep	sep
equal	equal
marketing	marketing
domine	domine
configuration	configuration
upn	upn
congo	congo
slr	slr
alte	alte
tin	tin
scout	scout
officers	officers
blonde	blonde
doctors	doctors
clifford	clifford
banks	banks
incorporated	incorporated
mega	mega
partners	partners
custom	custom
welfare	welfare
inquiry	inquiry
msnbc	msnbc
firenze	firenze
sdram	sdram
champagne	champagne
weak	weak
integer	integer
é	é
indians	indians
léon	léon
xss	xss
shooting	shooting
méxico	méxico
universidad	universidad
stark	stark
measurement	measurement
crow	crow
hdmi	hdmi
surrender	surrender
lunar	lunar
sketch	sketch
concerning	concerning
optics	optics
tlc	tlc
rape	rape
bells	bells
libri	libri
cdma	cdma
brunswick	brunswick
donna	donna
sitenotice	sitenotice
separator	separator
evolutionary	evolutionary
cameron	cameron
hang	hang
penelope	penelope
circuit	circuit
canadensis	canadensis
conservative	conservative
steiner	steiner
equation	equation
postal	postal
safari	safari
albania	albania
shotgun	shotgun
linguistics	linguistics
castello	castello
vorbis	vorbis
tyler	tyler
royale	royale
attention	attention
machines	machines
oklahoma	oklahoma
imaging	imaging
breath	breath
tape	tape
friendship	friendship
metadata	metadata
revision	revision
crm	crm
lexington	lexington
forming	forming
crossroads	crossroads
months	months
beloved	beloved
cop	cop
mfa	mfa
sie	sie
eleanor	eleanor
density	density
aqua	aqua
neumann	neumann
okw	okw
alto	alto
mall	mall
gcc	gcc
discoveries	discoveries
monarchy	monarchy
persons	persons
fork	fork
modernity	modernity
elf	elf
harvest	harvest
composition	composition
jvm	jvm
binding	binding
digest	digest
nero	nero
dmc	dmc
uruguay	uruguay
outstanding	outstanding
drake	drake
deen	deen
sophie	sophie
ocr	ocr
район	район
ofc	ofc
elliott	elliott
plague	plague
placed	placed
transit	transit
lakes	lakes
cube	cube
fuller	fuller
crc	crc
rail	rail
toxic	toxic
guys	guys
prey	prey
sodium	sodium
geneva	geneva
cult	cult
performing	performing
lesser	lesser
compagnie	compagnie
canon	canon
spiral	spiral
companies	companies
crimson	crimson
kl	kl
newspaper	newspaper
observations	observations
homepage	homepage
sue	sue
vanguard	vanguard
vp	vp
kathleen	kathleen
relative	relative
epa	epa
dhc	dhc
columns	columns
albums	albums
tp	tp
après	après
enemies	enemies
crop	crop
endangered	endangered
saved	saved
crj	crj
cygnus	cygnus
sofia	sofia
ahead	ahead
ordinary	ordinary
surprise	surprise
dal	dal
sean	sean
mozart	mozart
wikimania	wikimania
iec	iec
tiny	tiny
ran	ran
isis	isis
angle	angle
sind	sind
xviii	xviii
brit	brit
falcon	falcon
unusual	unusual
habsburg	habsburg
duc	duc
″	″
xavier	xavier
tierra	tierra
jubilee	jubilee
achievement	achievement
boeing	boeing
whose	whose
liberté	liberté
cow	cow
mason	mason
wc	wc
robertson	robertson
aron	aron
extensions	extensions
nlp	nlp
atlantis	atlantis
opus	opus
ati	ati
towers	towers
courage	courage
kr	kr
thirty	thirty
vessel	vessel
damage	damage
conversation	conversation
raven	raven
nueva	nueva
respect	respect
inch	inch
flood	flood
echoes	echoes
cellpadding	cellpadding
giving	giving
hippocampus	hippocampus
leone	leone
jsp	jsp
rufus	rufus
advantage	advantage
ama	ama
yeah	yeah
copa	copa
mh	mh
agricultural	agricultural
tempo	tempo
ton	ton
gia	gia
dash	dash
beaux	beaux
dancer	dancer
unlimited	unlimited
nile	nile
parents	parents
ass	ass
failure	failure
baba	baba
shepherd	shepherd
plos	plos
afghanistan	afghanistan
ctu	ctu
artillery	artillery
ale	ale
torres	torres
char	char
rpm	rpm
martial	martial
correct	correct
tennessee	tennessee
conversations	conversations
fraser	fraser
timeline	timeline
javier	javier
emotional	emotional
statement	statement
eagles	eagles
growing	growing
ranger	ranger
chapman	chapman
weird	weird
africanus	africanus
causes	causes
lu	lu
ole	ole
ferry	ferry
fell	fell
cds	cds
stevens	stevens
nypd	nypd
json	json
hessen	hessen
lil	lil
curse	curse
gibraltar	gibraltar
ontario	ontario
architect	architect
speaker	speaker
tone	tone
konrad	konrad
mysteries	mysteries
received	received
examination	examination
brien	brien
lieder	lieder
choir	choir
cis	cis
swat	swat
concrete	concrete
sich	sich
chasing	chasing
puppets	puppets
ρ	ρ
pump	pump
césar	césar
paranoid	paranoid
nmr	nmr
axn	axn
leisure	leisure
boundaries	boundaries
cue	cue
pywikipedia	pywikipedia
chambers	chambers
fp	fp
eating	eating
harbour	harbour
petroleum	petroleum
laurent	laurent
forbes	forbes
gf	gf
hurricane	hurricane
pn	pn
kw	kw
syntax	syntax
nhk	nhk
aftermath	aftermath
connor	connor
rude	rude
sailing	sailing
turns	turns
paradox	paradox
lambert	lambert
jour	jour
lol	lol
intervention	intervention
axel	axel
lazy	lazy
émile	émile
rhein	rhein
myths	myths
thee	thee
malaysia	malaysia
arcade	arcade
heard	heard
pirate	pirate
sds	sds
senior	senior
graphics	graphics
svt	svt
ramon	ramon
waterloo	waterloo
samba	samba
ata	ata
cycling	cycling
roosevelt	roosevelt
tigris	tigris
manfred	manfred
degree	degree
certificate	certificate
jeanne	jeanne
hollow	hollow
scarecrow	scarecrow
ссср	ссср
conversion	conversion
serpent	serpent
rl	rl
visible	visible
ats	ats
redirect	redirect
instruction	instruction
practices	practices
battles	battles
sheet	sheet
dinosaurs	dinosaurs
measure	measure
extension	extension
cerro	cerro
partnership	partnership
assistant	assistant
lazarus	lazarus
romeo	romeo
hardy	hardy
anterior	anterior
volunteer	volunteer
warriors	warriors
zf	zf
ils	ils
stability	stability
controversy	controversy
heartbeat	heartbeat
felipe	felipe
richardson	richardson
olympics	olympics
lisp	lisp
finite	finite
rear	rear
continental	continental
revealed	revealed
esa	esa
bernstein	bernstein
actors	actors
bubble	bubble
dominique	dominique
jo	jo
ptolemy	ptolemy
panel	panel
mayo	mayo
provided	provided
derek	derek
mal	mal
socket	socket
dee	dee
dk	dk
wasp	wasp
scroll	scroll
ind	ind
ko	ko
trophy	trophy
witness	witness
croatia	croatia
allied	allied
marsh	marsh
dimensions	dimensions
poem	poem
symposium	symposium
fuel	fuel
judy	judy
ani	ani
fortran	fortran
rudolph	rudolph
ambassador	ambassador
poets	poets
hoc	hoc
ard	ard
lua	lua
instruments	instruments
hotels	hotels
uprising	uprising
nacht	nacht
runaway	runaway
disco	disco
ngo	ngo
wear	wear
tvxq	tvxq
strategies	strategies
thief	thief
mos	mos
soup	soup
deleted	deleted
vintage	vintage
dat	dat
bauer	bauer
carcharhinus	carcharhinus
pseudo	pseudo
fim	fim
columbus	columbus
nxt	nxt
percy	percy
located	located
sandy	sandy
ida	ida
lips	lips
rer	rer
magnum	magnum
upload	upload
feed	feed
calls	calls
archibald	archibald
xe	xe
claudia	claudia
coord	coord
ski	ski
nina	nina
observatory	observatory
permanent	permanent
qr	qr
doubt	doubt
jg	jg
andrews	andrews
ecuador	ecuador
studi	studi
patent	patent
restoration	restoration
winds	winds
burton	burton
scholarship	scholarship
madame	madame
ul	ul
idol	idol
handbuch	handbuch
isr	isr
westport	westport
automatically	automatically
pk	pk
smtp	smtp
bas	bas
became	became
vf	vf
kara	kara
sco	sco
hull	hull
connecticut	connecticut
ceremony	ceremony
beverly	beverly
coll	coll
preliminary	preliminary
tablet	tablet
ot	ot
shady	shady
fv	fv
anger	anger
stalin	stalin
probably	probably
galerie	galerie
nigel	nigel
reasons	reasons
metropolis	metropolis
composite	composite
neon	neon
afm	afm
cobra	cobra
monk	monk
wpf	wpf
connect	connect
seminary	seminary
losing	losing
significance	significance
genetic	genetic
gui	gui
translator	translator
horses	horses
snes	snes
cca	cca
shapiro	shapiro
korean	korean
tnf	tnf
campo	campo
atari	atari
soyuz	soyuz
concolor	concolor
contra	contra
considered	considered
closed	closed
openoffice	openoffice
spa	spa
bison	bison
sixth	sixth
pubmed	pubmed
untitled	untitled
fcc	fcc
hyde	hyde
générale	générale
mips	mips
debate	debate
lepus	lepus
goto	goto
cpu	cpu
nest	nest
lionel	lionel
procedure	procedure
romanian	romanian
pantheon	pantheon
philips	philips
cradle	cradle
pittsburgh	pittsburgh
shoulder	shoulder
grain	grain
slc	slc
lange	lange
beam	beam
diabetes	diabetes
breathe	breathe
canto	canto
m_n	m_n
uc	uc
ora	ora
boo	boo
ecw	ecw
mona	mona
granada	granada
saving	saving
abba	abba
salem	salem
viola	viola
powerpc	powerpc
cots	cots
relation	relation
dig	dig
bayern	bayern
soleil	soleil
blason	blason
jose	jose
freiburg	freiburg
sid	sid
behaviour	behaviour
ntfs	ntfs
barrier	barrier
spike	spike
decline	decline
zwei	zwei
twitter	twitter
finger	finger
gaga	gaga
plato	plato
mah	mah
cleopatra	cleopatra
fs	fs
emerald	emerald
forbidden	forbidden
volta	volta
titan	titan
amanda	amanda
muse	muse
persia	persia
begins	begins
fontana	fontana
oslo	oslo
modeling	modeling
ear	ear
import	import
objective	objective
journals	journals
mandate	mandate
mf	mf
bk	bk
wto	wto
mev	mev
minimum	minimum
bund	bund
jacqueline	jacqueline
lens	lens
reunion	reunion
equipment	equipment
monobook	monobook
parti	parti
t_n	t_n
craft	craft
blogs	blogs
hormone	hormone
radius	radius
bleeding	bleeding
appropriate	appropriate
armenia	armenia
verse	verse
qatar	qatar
dahlia	dahlia
transform	transform
yu	yu
ini	ini
parsons	parsons
hmv	hmv
peninsula	peninsula
keyboard	keyboard
longer	longer
revelation	revelation
newsletter	newsletter
scientists	scientists
morocco	morocco
spectrum	spectrum
f_x	f_x
instrumental	instrumental
registry	registry
fg	fg
sri	sri
pole	pole
castro	castro
emission	emission
nato	nato
additional	additional
mifflin	mifflin
devices	devices
idiot	idiot
lego	lego
vengeance	vengeance
prose	prose
mtu	mtu
queens	queens
femmes	femmes
moss	moss
matlab	matlab
emile	emile
activision	activision
gruyter	gruyter
housing	housing
figures	figures
wolfram	wolfram
bremen	bremen
armee	armee
containing	containing
maiden	maiden
mood	mood
bailey	bailey
faa	faa
vor	vor
durham	durham
jahre	jahre
alexandra	alexandra
posterior	posterior
pavilion	pavilion
efi	efi
richards	richards
attribution	attribution
proper	proper
seems	seems
dresden	dresden
parties	parties
greene	greene
orders	orders
syn	syn
cincinnati	cincinnati
tycoon	tycoon
fo	fo
morton	morton
markus	markus
driven	driven
étienne	étienne
más	más
geographical	geographical
hoffman	hoffman
lynch	lynch
jul	jul
rica	rica
fighters	fighters
cel	cel
trading	trading
existence	existence
jürgen	jürgen
mime	mime
rae	rae
roh	roh
plata	plata
investment	investment
pad	pad
curtis	curtis
gatt	gatt
broke	broke
resurrection	resurrection
topics	topics
thursday	thursday
wrote	wrote
madagascar	madagascar
dad	dad
minds	minds
went	went
collections	collections
refugees	refugees
hush	hush
fernández	fernández
behavioral	behavioral
sx	sx
hammond	hammond
finish	finish
strikes	strikes
spell	spell
equity	equity
beneath	beneath
gerard	gerard
fib	fib
hdl	hdl
carnegie	carnegie
apart	apart
enfants	enfants
dice	dice
adaptation	adaptation
perception	perception
arg	arg
importance	importance
suny	suny
ángel	ángel
oskar	oskar
symbolic	symbolic
massive	massive
drag	drag
sig	sig
alu	alu
movements	movements
sutton	sutton
humanity	humanity
diagnosis	diagnosis
param	param
devils	devils
mississippi	mississippi
serbia	serbia
cyp	cyp
killers	killers
americas	americas
simone	simone
magical	magical
keeper	keeper
phil	phil
webm	webm
michele	michele
presence	presence
doll	doll
aquila	aquila
orbit	orbit
posix	posix
pspace	pspace
thailand	thailand
spears	spears
gem	gem
asylum	asylum
xf	xf
broad	broad
isu	isu
lou	lou
knock	knock
translatewiki	translatewiki
propaganda	propaganda
inferno	inferno
reilly	reilly
diva	diva
morte	morte
tod	tod
xn	xn
cecil	cecil
sporting	sporting
vox	vox
ssi	ssi
boss	boss
mothers	mothers
excellence	excellence
wan	wan
apt	apt
hanna	hanna
detailed	detailed
transparency	transparency
desk	desk
reaction	reaction
exploring	exploring
sheep	sheep
tactics	tactics
macht	macht
classes	classes
sahara	sahara
seek	seek
tip	tip
lamp	lamp
monochrome	monochrome
pot	pot
cello	cello
shared	shared
fundamental	fundamental
skeleton	skeleton
español	español
catalog	catalog
robbins	robbins
chuck	chuck
osu	osu
baghdad	baghdad
ivory	ivory
membrane	membrane
rational	rational
tours	tours
bart	bart
som	som
croix	croix
holdings	holdings
preferences	preferences
dieter	dieter
olive	olive
webster	webster
firm	firm
weimar	weimar
georgian	georgian
easter	easter
heil	heil
soe	soe
maxwell	maxwell
transportation	transportation
serve	serve
dependent	dependent
mead	mead
wap	wap
hansen	hansen
elephas	elephas
cologne	cologne
numeric	numeric
volunteers	volunteers
beats	beats
hb	hb
clan	clan
anders	anders
mesh	mesh
stick	stick
ashley	ashley
resident	resident
offensive	offensive
actress	actress
rosenberg	rosenberg
viscount	viscount
yuri	yuri
recorded	recorded
ohne	ohne
calvin	calvin
mecklenburg	mecklenburg
sang	sang
defined	defined
forte	forte
ala	ala
npc	npc
gonzález	gonzález
genie	genie
williamson	williamson
expansion	expansion
whether	whether
arh	arh
ncbi	ncbi
sala	sala
_whiteshoulders	_whiteshoulders
principal	principal
p_n	p_n
harlem	harlem
tap	tap
daf	daf
bos	bos
sunny	sunny
ideal	ideal
battista	battista
administrator	administrator
dare	dare
pri	pri
sent	sent
vortex	vortex
believed	believed
afternoon	afternoon
hai	hai
divide	divide
rita	rita
whitney	whitney
alfonso	alfonso
browser	browser
agents	agents
austrian	austrian
mob	mob
smooth	smooth
pirates	pirates
benny	benny
shaped	shaped
tat	tat
slavery	slavery
shame	shame
corona	corona
vanity	vanity
dong	dong
sepc	sepc
healing	healing
sole	sole
lex	lex
recherche	recherche
detection	detection
simply	simply
threat	threat
nwa	nwa
dsp	dsp
coup	coup
quad	quad
iw	iw
bpi	bpi
reconnaissance	reconnaissance
acb	acb
poison	poison
castles	castles
economist	economist
beacon	beacon
balls	balls
married	married
unesco	unesco
islas	islas
mes	mes
appendchild	appendchild
corn	corn
elimination	elimination
reginald	reginald
rn	rn
manuscript	manuscript
adm	adm
gospel	gospel
responsibility	responsibility
nous	nous
ari	ari
fcw	fcw
patria	patria
sánchez	sánchez
hunger	hunger
blair	blair
puppet	puppet
aq	aq
gq	gq
tn	tn
tre	tre
trials	trials
schloss	schloss
sic	sic
salmon	salmon
eur	eur
icc	icc
consortium	consortium
tests	tests
rutgers	rutgers
iia	iia
_i	_i
jelly	jelly
usage	usage
fir	fir
spirits	spirits
cyprus	cyprus
necessary	necessary
inspector	inspector
ietf	ietf
lily	lily
bl	bl
münster	münster
ö	ö
carta	carta
usd	usd
seat	seat
msg	msg
brooks	brooks
veronica	veronica
bloomington	bloomington
algorithms	algorithms
xb	xb
horizons	horizons
ó	ó
biggest	biggest
worker	worker
klub	klub
lav	lav
epub	epub
xa	xa
tender	tender
adding	adding
adi	adi
domenico	domenico
riley	riley
hh	hh
manufacturing	manufacturing
ppp	ppp
paid	paid
tas	tas
extraordinary	extraordinary
hui	hui
hochschule	hochschule
frei	frei
linguistic	linguistic
breakfast	breakfast
dilemma	dilemma
itself	itself
kbps	kbps
mutual	mutual
ı	ı
dg	dg
sheffield	sheffield
csf	csf
ige	ige
belarus	belarus
approaches	approaches
comme	comme
choose	choose
boundary	boundary
preview	preview
fingers	fingers
hitman	hitman
mister	mister
stevenson	stevenson
luc	luc
similar	similar
werke	werke
chevalier	chevalier
maintenance	maintenance
vx	vx
latina	latina
primo	primo
leopardus	leopardus
tension	tension
diane	diane
docs	docs
watts	watts
wit	wit
ipairs	ipairs
bitter	bitter
msc	msc
tear	tear
braun	braun
usc	usc
russo	russo
willy	willy
giants	giants
allow	allow
proposal	proposal
draw	draw
afi	afi
friendly	friendly
bread	bread
globalsecurity	globalsecurity
scandal	scandal
illustrations	illustrations
samurai	samurai
midway	midway
pieter	pieter
plaque	plaque
nadh	nadh
pull	pull
moto	moto
cristatus	cristatus
conduct	conduct
deception	deception
gilles	gilles
fao	fao
gamma	gamma
mao	mao
citrus	citrus
bonnie	bonnie
winners	winners
painted	painted
lighthouse	lighthouse
took	took
resolve	resolve
soho	soho
ricardo	ricardo
hover	hover
،	،
useful	useful
eliot	eliot
gore	gore
cent	cent
vatican	vatican
leg	leg
reynolds	reynolds
socialism	socialism
basics	basics
grandes	grandes
xyz	xyz
fútbol	fútbol
nic	nic
merchant	merchant
buried	buried
categories	categories
ferguson	ferguson
charity	charity
chosen	chosen
gis	gis
gottfried	gottfried
haunted	haunted
garde	garde
père	père
nervous	nervous
н	н
pigs	pigs
stable	stable
savoy	savoy
pipe	pipe
porte	porte
affect	affect
deluxe	deluxe
participation	participation
feast	feast
buddy	buddy
genetics	genetics
wwii	wwii
gemini	gemini
callicebus	callicebus
hypothesis	hypothesis
supply	supply
teresa	teresa
qs	qs
searching	searching
könig	könig
debut	debut
nyse	nyse
manuscripts	manuscripts
nis	nis
alphonse	alphonse
jenkins	jenkins
adds	adds
assistance	assistance
agenda	agenda
initial	initial
_a	_a
rtf	rtf
satan	satan
shit	shit
expo	expo
forth	forth
benefit	benefit
cruel	cruel
serge	serge
lawn	lawn
textbook	textbook
gfp	gfp
kung	kung
bv	bv
eleven	eleven
fundamentals	fundamentals
sweat	sweat
engineer	engineer
reef	reef
spotlight	spotlight
packet	packet
cluster	cluster
hercules	hercules
cam	cam
frog	frog
depth	depth
darmstadt	darmstadt
invincible	invincible
hash	hash
cvs	cvs
intelligent	intelligent
activities	activities
directions	directions
consumer	consumer
reel	reel
threshold	threshold
markets	markets
mems	mems
tam	tam
acer	acer
pax	pax
aerospace	aerospace
attitude	attitude
requirements	requirements
marius	marius
marion	marion
smithsonian	smithsonian
regime	regime
actually	actually
scar	scar
average	average
splash	splash
steady	steady
wednesday	wednesday
clara	clara
particles	particles
extinction	extinction
pereira	pereira
mainz	mainz
equality	equality
shout	shout
rip	rip
communist	communist
christi	christi
privacy	privacy
charter	charter
partial	partial
saas	saas
instrument	instrument
armoiries	armoiries
separate	separate
gomez	gomez
becomes	becomes
siemens	siemens
pct	pct
aperture	aperture
innocence	innocence
fill	fill
maxim	maxim
mbe	mbe
greeks	greeks
uml	uml
jackie	jackie
aime	aime
titus	titus
r_n	r_n
dora	dora
unless	unless
ces	ces
fragile	fragile
wealth	wealth
stations	stations
crusade	crusade
fauna	fauna
wenn	wenn
phillip	phillip
cfg	cfg
registration	registration
metallica	metallica
uncertainty	uncertainty
gathering	gathering
bend	bend
cruise	cruise
patient	patient
weeks	weeks
guitars	guitars
sterling	sterling
dub	dub
sphere	sphere
attacks	attacks
hail	hail
westminster	westminster
seals	seals
delivered	delivered
lone	lone
lim	lim
bohemian	bohemian
continue	continue
mexicana	mexicana
vehicles	vehicles
mirrors	mirrors
basis	basis
sws	sws
polity	polity
captcha	captcha
cyrus	cyrus
troops	troops
garage	garage
anywhere	anywhere
picea	picea
instant	instant
ink	ink
bias	bias
cure	cure
knife	knife
latest	latest
symbols	symbols
babylonian	babylonian
viewer	viewer
unicef	unicef
dental	dental
mms	mms
rod	rod
divided	divided
cheese	cheese
ζ	ζ
bing	bing
pond	pond
birmingham	birmingham
reply	reply
ssd	ssd
dinner	dinner
universities	universities
rep	rep
cowboy	cowboy
siempre	siempre
sold	sold
patriot	patriot
fai	fai
exposition	exposition
ub	ub
constitutional	constitutional
dietrich	dietrich
svenska	svenska
nps	nps
leftarm	leftarm
macdonald	macdonald
trevor	trevor
guards	guards
continuous	continuous
nand	nand
louisiana	louisiana
humans	humans
mari	mari
t_i	t_i
prairie	prairie
marvin	marvin
subst	subst
ruins	ruins
oxygen	oxygen
omar	omar
mendel	mendel
amt	amt
oasis	oasis
died	died
ks	ks
alexis	alexis
ono	ono
walsh	walsh
toledo	toledo
esp	esp
strasbourg	strasbourg
drew	drew
angola	angola
auckland	auckland
vancouver	vancouver
julio	julio
ump	ump
leaving	leaving
cal	cal
québec	québec
swim	swim
gaius	gaius
olga	olga
dur	dur
mexican	mexican
keller	keller
crush	crush
looks	looks
planets	planets
taxi	taxi
occidentalis	occidentalis
nuevo	nuevo
armand	armand
autonomous	autonomous
fiav	fiav
developing	developing
tucker	tucker
hayes	hayes
blanche	blanche
punishment	punishment
degrees	degrees
pioneers	pioneers
substance	substance
becoming	becoming
tls	tls
cho	cho
salisbury	salisbury
rangers	rangers
separation	separation
terence	terence
warp	warp
descent	descent
nucleus	nucleus
roof	roof
enterprises	enterprises
mellon	mellon
sample	sample
currency	currency
groove	groove
wins	wins
walton	walton
homeland	homeland
madeleine	madeleine
emilio	emilio
wolfe	wolfe
fab	fab
leeds	leeds
punch	punch
gsp	gsp
toni	toni
fist	fist
sem	sem
alley	alley
discovered	discovered
armée	armée
loch	loch
benz	benz
ussr	ussr
premiere	premiere
cryptography	cryptography
claudius	claudius
nash	nash
included	included
nose	nose
injection	injection
daisy	daisy
pico	pico
republican	republican
lennon	lennon
dia	dia
gypsy	gypsy
regions	regions
bernardo	bernardo
anarchy	anarchy
mining	mining
dogg	dogg
bowie	bowie
trying	trying
ahmed	ahmed
rw	rw
omnibus	omnibus
mapping	mapping
ntsc	ntsc
annotated	annotated
pratt	pratt
listening	listening
erj	erj
embassy	embassy
generator	generator
casino	casino
griffin	griffin
alexandria	alexandria
dama	dama
intro	intro
pam	pam
katy	katy
pia	pia
gangsta	gangsta
sac	sac
primitive	primitive
arabian	arabian
likely	likely
breaks	breaks
audience	audience
larger	larger
mondo	mondo
denver	denver
eau	eau
rhinoceros	rhinoceros
fancy	fancy
zx	zx
medley	medley
torino	torino
bucharest	bucharest
gcd	gcd
zn	zn
engagement	engagement
fragment	fragment
shoe	shoe
himself	himself
minneapolis	minneapolis
andrés	andrés
particle	particle
wav	wav
eduardo	eduardo
maine	maine
pod	pod
blizzard	blizzard
leigh	leigh
creating	creating
electrical	electrical
diet	diet
interscope	interscope
romana	romana
expert	expert
heller	heller
collision	collision
gottlieb	gottlieb
survive	survive
édouard	édouard
hymns	hymns
pf	pf
psa	psa
saunders	saunders
mechanism	mechanism
côte	côte
nds	nds
lola	lola
giacomo	giacomo
historian	historian
ipc	ipc
measures	measures
siegfried	siegfried
consequences	consequences
csv	csv
builder	builder
österreich	österreich
collapsible	collapsible
organic	organic
nathaniel	nathaniel
_n	_n
majority	majority
plains	plains
molly	molly
destination	destination
damned	damned
guides	guides
definitive	definitive
gómez	gómez
railways	railways
dodge	dodge
wilde	wilde
coverage	coverage
joyce	joyce
ren	ren
prepared	prepared
showing	showing
amp	amp
uniform	uniform
matthias	matthias
louvre	louvre
americanus	americanus
misty	misty
dar	dar
tumor	tumor
pu	pu
riding	riding
traveling	traveling
dial	dial
tex	tex
prelude	prelude
commissioner	commissioner
identifier	identifier
thumb	thumb
visiting	visiting
stripped	stripped
toto	toto
monetary	monetary
hmas	hmas
patients	patients
rebirth	rebirth
mono	mono
buck	buck
largest	largest
mathworld	mathworld
trailer	trailer
earthquake	earthquake
provincial	provincial
everyday	everyday
assassination	assassination
thru	thru
dolphin	dolphin
anzac	anzac
armies	armies
cab	cab
bosnia	bosnia
differences	differences
sousa	sousa
learned	learned
hk	hk
cnet	cnet
angela	angela
projection	projection
wat	wat
tropical	tropical
domingo	domingo
clarence	clarence
_whiteborder	_whiteborder
bless	bless
wikitext	wikitext
novo	novo
rhodes	rhodes
philippines	philippines
vowel	vowel
kraft	kraft
goodman	goodman
isabel	isabel
lima	lima
tca	tca
mom	mom
azul	azul
g_n	g_n
apec	apec
civic	civic
exp	exp
kernel	kernel
ri	ri
cliff	cliff
carr	carr
ssr	ssr
alta	alta
rodney	rodney
loire	loire
puma	puma
elvis	elvis
chronology	chronology
bien	bien
interchange	interchange
failed	failed
umts	umts
turbo	turbo
johnston	johnston
trance	trance
pcb	pcb
y_n	y_n
guardians	guardians
timor	timor
peru	peru
conscience	conscience
primer	primer
archer	archer
chester	chester
champs	champs
bsc	bsc
marino	marino
payne	payne
noi	noi
replay	replay
luxembourg	luxembourg
cmos	cmos
ham	ham
mbc	mbc
liability	liability
willis	willis
attachment	attachment
droit	droit
algol	algol
computational	computational
developers	developers
previously	previously
britannia	britannia
lift	lift
portuguese	portuguese
facility	facility
mccarthy	mccarthy
provide	provide
candle	candle
ntsb	ntsb
boxing	boxing
riders	riders
opt	opt
dirt	dirt
sed	sed
northwest	northwest
coordinate	coordinate
brass	brass
accuracy	accuracy
ecc	ecc
shirley	shirley
ide	ide
coding	coding
trace	trace
bergen	bergen
sachs	sachs
coordinates	coordinates
raise	raise
harald	harald
wash	wash
levine	levine
jake	jake
vk	vk
halle	halle
copper	copper
augustin	augustin
vo	vo
mongolia	mongolia
dragons	dragons
poverty	poverty
jigsaw	jigsaw
horace	horace
salvation	salvation
napoli	napoli
radioactive	radioactive
ramón	ramón
randy	randy
peuple	peuple
outta	outta
ugly	ugly
paintings	paintings
vba	vba
visitors	visitors
hoffmann	hoffmann
constellation	constellation
naoh	naoh
flex	flex
henderson	henderson
plenty	plenty
elaine	elaine
nec	nec
honneur	honneur
expected	expected
utility	utility
spatial	spatial
todo	todo
martínez	martínez
vault	vault
deportivo	deportivo
nite	nite
papua	papua
federico	federico
courts	courts
require	require
seeds	seeds
nsf	nsf
vertigo	vertigo
phenomenon	phenomenon
observation	observation
scan	scan
burg	burg
gill	gill
brussels	brussels
cet	cet
andrei	andrei
muntiacus	muntiacus
strict	strict
lin	lin
balloon	balloon
vine	vine
shown	shown
een	een
raised	raised
asean	asean
hale	hale
blau	blau
orleans	orleans
programs	programs
neighborhood	neighborhood
skyline	skyline
mémoire	mémoire
wp	wp
haiti	haiti
claw	claw
eads	eads
ernesto	ernesto
coalition	coalition
pid	pid
mikhail	mikhail
e_n	e_n
tous	tous
flames	flames
deletion	deletion
painter	painter
cards	cards
walther	walther
flies	flies
knox	knox
credits	credits
essex	essex
mio	mio
lars	lars
sector	sector
emc	emc
brandenburg	brandenburg
calculus	calculus
synthesis	synthesis
uganda	uganda
spiegel	spiegel
kingston	kingston
sandra	sandra
tome	tome
stub	stub
temporal	temporal
improvement	improvement
indica	indica
equations	equations
≈	≈
noa	noa
fail	fail
gérard	gérard
tunisia	tunisia
toi	toi
dakota	dakota
wandering	wandering
farmer	farmer
ik	ik
awb	awb
stroke	stroke
ufo	ufo
southeast	southeast
semiconductor	semiconductor
tus	tus
fer	fer
though	though
beyoncé	beyoncé
copenhagen	copenhagen
missouri	missouri
española	española
dominican	dominican
encore	encore
infrastructure	infrastructure
intermediate	intermediate
nuestra	nuestra
campaigns	campaigns
probe	probe
hanover	hanover
acquisition	acquisition
teach	teach
sell	sell
wikipedias	wikipedias
starr	starr
drawn	drawn
vin	vin
cad	cad
accelerator	accelerator
fools	fools
thou	thou
kfc	kfc
clone	clone
permissions	permissions
vis	vis
mack	mack
probability	probability
superstar	superstar
lists	lists
olympia	olympia
scripts	scripts
rsc	rsc
marquis	marquis
breakdown	breakdown
realm	realm
often	often
enrique	enrique
mea	mea
abcd	abcd
vv	vv
étude	étude
tang	tang
belief	belief
не	не
gut	gut
marek	marek
prism	prism
starting	starting
cha	cha
colored	colored
discipline	discipline
jts	jts
especially	especially
marry	marry
confusion	confusion
novels	novels
twice	twice
sixteen	sixteen
württemberg	württemberg
tostring	tostring
ladder	ladder
whistle	whistle
emerging	emerging
crowd	crowd
fatal	fatal
morality	morality
exception	exception
genealogy	genealogy
camel	camel
solitude	solitude
eurasia	eurasia
ifpi	ifpi
armored	armored
raising	raising
happen	happen
​	​
viktor	viktor
passed	passed
randall	randall
moran	moran
knowing	knowing
petra	petra
nippon	nippon
imf	imf
bonus	bonus
τ	τ
isles	isles
integrity	integrity
appendix	appendix
cannon	cannon
fuchs	fuchs
throw	throw
simmons	simmons
proxy	proxy
ä	ä
aspect	aspect
yugoslavia	yugoslavia
lancaster	lancaster
producer	producer
interviews	interviews
monitoring	monitoring
genome	genome
praise	praise
engines	engines
rightarm	rightarm
ordo	ordo
juno	juno
controlled	controlled
stem	stem
partei	partei
designer	designer
nigra	nigra
insight	insight
temperature	temperature
hunting	hunting
destroy	destroy
alles	alles
alison	alison
flores	flores
eurovision	eurovision
offset	offset
kal	kal
reflex	reflex
griffith	griffith
chang	chang
koh	koh
purge	purge
tourism	tourism
bertrand	bertrand
guilty	guilty
prophets	prophets
scarlet	scarlet
jamie	jamie
volk	volk
vmware	vmware
wikibase	wikibase
mostly	mostly
capitalism	capitalism
export	export
lean	lean
salzburg	salzburg
nominated	nominated
tsv	tsv
fierce	fierce
ecological	ecological
acl	acl
variations	variations
holly	holly
burke	burke
wade	wade
bout	bout
sentinel	sentinel
nigeria	nigeria
tg	tg
arxiv	arxiv
elections	elections
contre	contre
pmc	pmc
sitting	sitting
nevada	nevada
iba	iba
memphis	memphis
indicus	indicus
resonance	resonance
bradford	bradford
attr	attr
driving	driving
alf	alf
ifrs	ifrs
tune	tune
sets	sets
innocent	innocent
contents	contents
longman	longman
mackenzie	mackenzie
rosemary	rosemary
vacation	vacation
cunningham	cunningham
reid	reid
sine	sine
janeiro	janeiro
vm	vm
usaf	usaf
scribner	scribner
flute	flute
klavier	klavier
prisoner	prisoner
rossi	rossi
collapsed	collapsed
nursing	nursing
kraków	kraków
kaufmann	kaufmann
monaco	monaco
guatemala	guatemala
aura	aura
thai	thai
christie	christie
flak	flak
billion	billion
showcase	showcase
nave	nave
tracy	tracy
topology	topology
wellington	wellington
göttingen	göttingen
bliss	bliss
literacy	literacy
afro	afro
runner	runner
moreno	moreno
tapes	tapes
experiences	experiences
flac	flac
actual	actual
pearson	pearson
pigeon	pigeon
nutrition	nutrition
engel	engel
isi	isi
facto	facto
weaver	weaver
stardust	stardust
exposure	exposure
trash	trash
quo	quo
experiments	experiments
iceland	iceland
poetic	poetic
sergio	sergio
somethin	somethin
rust	rust
drunk	drunk
guido	guido
involved	involved
ipcc	ipcc
introducing	introducing
imo	imo
boots	boots
bunny	bunny
enhanced	enhanced
tiff	tiff
dis	dis
oa	oa
duel	duel
component	component
citadel	citadel
mis	mis
bmc	bmc
praha	praha
residence	residence
graffiti	graffiti
garcia	garcia
mainstream	mainstream
capacity	capacity
tribes	tribes
mci	mci
mosfet	mosfet
suv	suv
doo	doo
bpp	bpp
soy	soy
gymnasium	gymnasium
supported	supported
eggs	eggs
laguna	laguna
decisions	decisions
date_string	date_string
ahl	ahl
prunus	prunus
gackt	gackt
supérieure	supérieure
trinidad	trinidad
horst	horst
bcd	bcd
removed	removed
wbc	wbc
mathers	mathers
chains	chains
circa	circa
fh	fh
amber	amber
på	på
nicole	nicole
ji	ji
toro	toro
seti	seti
lit	lit
combined	combined
nino	nino
neural	neural
honorary	honorary
olivier	olivier
covered	covered
wikia	wikia
unexpected	unexpected
japonica	japonica
crawford	crawford
bx	bx
territories	territories
rar	rar
nano	nano
ballads	ballads
marathon	marathon
langue	langue
gmc	gmc
macedonia	macedonia
norte	norte
jurassic	jurassic
guess	guess
mae	mae
spark	spark
blanco	blanco
harrier	harrier
gwt	gwt
suis	suis
consider	consider
breed	breed
claus	claus
fiber	fiber
wheels	wheels
lett	lett
prior	prior
joins	joins
toolkit	toolkit
matching	matching
integral	integral
ncc	ncc
marilyn	marilyn
transformers	transformers
п	п
cheers	cheers
wrap	wrap
cedar	cedar
daughters	daughters
neck	neck
tolerance	tolerance
variant	variant
bomber	bomber
alternate	alternate
bleu	bleu
weg	weg
allison	allison
chick	chick
algebraic	algebraic
convert	convert
vernon	vernon
ccff	ccff
sanders	sanders
sen	sen
execution	execution
adolphe	adolphe
wagon	wagon
davidson	davidson
reservation	reservation
hyper	hyper
associate	associate
vitro	vitro
attempt	attempt
cuba	cuba
naughty	naughty
treatise	treatise
cassell	cassell
seventeen	seventeen
generated	generated
jvc	jvc
lauren	lauren
sammy	sammy
festa	festa
mcdonnell	mcdonnell
csu	csu
borders	borders
tekken	tekken
mic	mic
diss	diss
counting	counting
fdp	fdp
frédéric	frédéric
pérez	pérez
logical	logical
sales	sales
elo	elo
dup	dup
crest	crest
legs	legs
kinase	kinase
wr	wr
advisory	advisory
coin	coin
millions	millions
asiatic	asiatic
quintus	quintus
lance	lance
compiled	compiled
advancement	advancement
meles	meles
racial	racial
delay	delay
blackout	blackout
appear	appear
cascade	cascade
cabinet	cabinet
galileo	galileo
setup	setup
cone	cone
jd	jd
natalie	natalie
ukrainian	ukrainian
scandinavian	scandinavian
flavius	flavius
sinclair	sinclair
sasha	sasha
boa	boa
peacock	peacock
у	у
rope	rope
luz	luz
grenade	grenade
misery	misery
nlm	nlm
dsl	dsl
enrico	enrico
banking	banking
goddess	goddess
tbs	tbs
aps	aps
deeper	deeper
dev	dev
keeping	keeping
samantha	samantha
epr	epr
addition	addition
sevilla	sevilla
serif	serif
medici	medici
msdn	msdn
nuvola	nuvola
towns	towns
dump	dump
jihad	jihad
jacket	jacket
passenger	passenger
bugs	bugs
shade	shade
liga	liga
iata	iata
remembrance	remembrance
yorkshire	yorkshire
bigger	bigger
lounge	lounge
pyramid	pyramid
ck	ck
tiempo	tiempo
cyril	cyril
sit	sit
ming	ming
glados	glados
polymer	polymer
districts	districts
kt	kt
temp	temp
employment	employment
eq	eq
populus	populus
dating	dating
scars	scars
cyber	cyber
airborne	airborne
recipes	recipes
arctocephalus	arctocephalus
constable	constable
lung	lung
tec	tec
rally	rally
trax	trax
amelia	amelia
usually	usually
illustration	illustration
barrel	barrel
regis	regis
philharmonic	philharmonic
gprs	gprs
bom	bom
relevant	relevant
mat	mat
ivb	ivb
dock	dock
feels	feels
copyleft	copyleft
camille	camille
centennial	centennial
amateur	amateur
hn	hn
freenode	freenode
slip	slip
domini	domini
quand	quand
largo	largo
ranch	ranch
encryption	encryption
kitty	kitty
igm	igm
mushroom	mushroom
vr	vr
regards	regards
frankfurter	frankfurter
panama	panama
derby	derby
proud	proud
directors	directors
proc	proc
chorus	chorus
sour	sour
evan	evan
explain	explain
pdb	pdb
kane	kane
sketches	sketches
carey	carey
opportunity	opportunity
adaptive	adaptive
zurich	zurich
dpi	dpi
barn	barn
hw	hw
induced	induced
voodoo	voodoo
julien	julien
bea	bea
instructions	instructions
roulette	roulette
mines	mines
elastic	elastic
lava	lava
günther	günther
tsr	tsr
architects	architects
hahn	hahn
apis	apis
л	л
abl	abl
stade	stade
drawings	drawings
willie	willie
domino	domino
rhino	rhino
creatures	creatures
signals	signals
geffen	geffen
sergeant	sergeant
turin	turin
tui	tui
calm	calm
juliet	juliet
inf	inf
melissa	melissa
lullaby	lullaby
chapters	chapters
dates	dates
josh	josh
manor	manor
topic	topic
generals	generals
wm	wm
tuesday	tuesday
watching	watching
daylight	daylight
strictly	strictly
ι	ι
nashville	nashville
assisted	assisted
stated	stated
bal	bal
rico	rico
chancellor	chancellor
gts	gts
vhdl	vhdl
allowed	allowed
gives	gives
rural	rural
creep	creep
nell	nell
e_i	e_i
pavel	pavel
bavaria	bavaria
banana	banana
dominion	dominion
vers	vers
intended	intended
ivy	ivy
bacon	bacon
pill	pill
buddha	buddha
lexicon	lexicon
conflicts	conflicts
irene	irene
discover	discover
hungry	hungry
fédération	fédération
bacteria	bacteria
neutral	neutral
mina	mina
lite	lite
veterans	veterans
gmt	gmt
karel	karel
suffix	suffix
meister	meister
cursor	cursor
impulse	impulse
á	á
battalion	battalion
income	income
d_i	d_i
teddy	teddy
thermal	thermal
naomi	naomi
heath	heath
webb	webb
otis	otis
registered	registered
arrival	arrival
hpv	hpv
foods	foods
highland	highland
p_k	p_k
centrale	centrale
scales	scales
equilibrium	equilibrium
selective	selective
elliot	elliot
fas	fas
becker	becker
canterbury	canterbury
holder	holder
instagram	instagram
quote	quote
clyde	clyde
fake	fake
dall	dall
anime	anime
package	package
floating	floating
provinces	provinces
gave	gave
romanum	romanum
vhf	vhf
jill	jill
monograph	monograph
pathology	pathology
seeing	seeing
psk	psk
diesel	diesel
oo	oo
beau	beau
reservoir	reservoir
covenant	covenant
ty	ty
amadeus	amadeus
distant	distant
coil	coil
sherlock	sherlock
mirage	mirage
isabella	isabella
jets	jets
moldova	moldova
dani	dani
francois	francois
geek	geek
overseas	overseas
cuts	cuts
iana	iana
tide	tide
serie	serie
fried	fried
regarding	regarding
worry	worry
cardinal	cardinal
merrill	merrill
bentley	bentley
thick	thick
atf	atf
cooperative	cooperative
morrow	morrow
uni	uni
kissed	kissed
policies	policies
everywhere	everywhere
filippo	filippo
h_i	h_i
anxiety	anxiety
surrey	surrey
exercise	exercise
sanctus	sanctus
lorraine	lorraine
mart	mart
dic	dic
glorious	glorious
partition	partition
cargo	cargo
bfi	bfi
monroe	monroe
olsen	olsen
frederic	frederic
tragic	tragic
cor	cor
fest	fest
threatened	threatened
skies	skies
alfredo	alfredo
kept	kept
stefano	stefano
elsewhere	elsewhere
symmetry	symmetry
hara	hara
repubblica	repubblica
richmond	richmond
leap	leap
miracles	miracles
tier	tier
ptsd	ptsd
pops	pops
mandatory	mandatory
hunters	hunters
although	although
tri	tri
dart	dart
mitsubishi	mitsubishi
igor	igor
mole	mole
caterpillar	caterpillar
competitive	competitive
xc	xc
kda	kda
casey	casey
sensation	sensation
digit	digit
amendment	amendment
marlborough	marlborough
injury	injury
agnus	agnus
continuity	continuity
ij	ij
visa	visa
clemens	clemens
mss	mss
mhnt	mhnt
wrapper	wrapper
silk	silk
moth	moth
steal	steal
nassau	nassau
herzegovina	herzegovina
ret	ret
segment	segment
esprit	esprit
moved	moved
dms	dms
planes	planes
cesare	cesare
avalon	avalon
collar	collar
ey	ey
weinberg	weinberg
saviour	saviour
willow	willow
developed	developed
multimedia	multimedia
estonia	estonia
dudley	dudley
zdf	zdf
sola	sola
pvp	pvp
examples	examples
appearance	appearance
bust	bust
ter	ter
planetary	planetary
sysop	sysop
mauro	mauro
macro	macro
treasury	treasury
markup	markup
gdp	gdp
„	„
hampshire	hampshire
tongue	tongue
doyle	doyle
mammals	mammals
described	described
truly	truly
waste	waste
haut	haut
lip	lip
telecom	telecom
pawn	pawn
finale	finale
churches	churches
vale	vale
illegal	illegal
sandwich	sandwich
relativity	relativity
xt	xt
parish	parish
notorious	notorious
alfa	alfa
rv	rv
thornton	thornton
clement	clement
q_i	q_i
abbott	abbott
garrett	garrett
rent	rent
christophe	christophe
ascap	ascap
merge	merge
spread	spread
normandie	normandie
rotation	rotation
providence	providence
benedict	benedict
dylan	dylan
maid	maid
nuts	nuts
rei	rei
v_n	v_n
hen	hen
jsa	jsa
iaa	iaa
sociale	sociale
comet	comet
bu	bu
potato	potato
tao	tao
glossary	glossary
romano	romano
caves	caves
voltage	voltage
ramsay	ramsay
relationships	relationships
plug	plug
rav	rav
accounting	accounting
hopes	hopes
cove	cove
général	général
ecstasy	ecstasy
hack	hack
billie	billie
profit	profit
maggie	maggie
bike	bike
voor	voor
cosmic	cosmic
fontaine	fontaine
rockin	rockin
efta	efta
drill	drill
yan	yan
sloan	sloan
quintet	quintet
avril	avril
lse	lse
boyd	boyd
creator	creator
paste	paste
dada	dada
ebu	ebu
fading	fading
logan	logan
ew	ew
usda	usda
cellular	cellular
lehmann	lehmann
prussia	prussia
obsession	obsession
respiratory	respiratory
nfs	nfs
curtain	curtain
salvatore	salvatore
dickinson	dickinson
dhl	dhl
celestial	celestial
therefore	therefore
dios	dios
sequences	sequences
phi	phi
rockefeller	rockefeller
ttl	ttl
lucia	lucia
anybody	anybody
blame	blame
exterior	exterior
headquarters	headquarters
imp	imp
bangkok	bangkok
archived	archived
roller	roller
rté	rté
adelaide	adelaide
globalization	globalization
speeches	speeches
dungeon	dungeon
rollback	rollback
jyp	jyp
mohammed	mohammed
computation	computation
helsinki	helsinki
gdi	gdi
suggestions	suggestions
più	più
domains	domains
fd	fd
terrible	terrible
swords	swords
caught	caught
luftwaffe	luftwaffe
lesson	lesson
closing	closing
sourcebook	sourcebook
mala	mala
sciurus	sciurus
dmx	dmx
flip	flip
sj	sj
notable	notable
arctos	arctos
_white	_white
implementation	implementation
kafka	kafka
heron	heron
gerd	gerd
sauce	sauce
agnes	agnes
partner	partner
wilkinson	wilkinson
nokia	nokia
crescent	crescent
tuberculosis	tuberculosis
verbal	verbal
purposes	purposes
adagio	adagio
listed	listed
chem	chem
hanging	hanging
augusto	augusto
effective	effective
esrb	esrb
coo	coo
africana	africana
korn	korn
torch	torch
twins	twins
comfort	comfort
genus	genus
moll	moll
substitute	substitute
spam	spam
yankee	yankee
balaenoptera	balaenoptera
dirk	dirk
goldman	goldman
zebra	zebra
rk	rk
phosphate	phosphate
leroy	leroy
cardiac	cardiac
uptown	uptown
trump	trump
tcl	tcl
bnf	bnf
roar	roar
breakthrough	breakthrough
cnrs	cnrs
sint	sint
mimi	mimi
lib	lib
barker	barker
developments	developments
clayton	clayton
armor	armor
raúl	raúl
mysterious	mysterious
saxony	saxony
highest	highest
lobe	lobe
titles	titles
marin	marin
lucien	lucien
anita	anita
customs	customs
quebec	quebec
connected	connected
garland	garland
indigo	indigo
gallus	gallus
wiktionary	wiktionary
bourne	bourne
preston	preston
rib	rib
shuttle	shuttle
♪	♪
themselves	themselves
summa	summa
chili	chili
clinic	clinic
chinensis	chinensis
modulation	modulation
quasi	quasi
harriet	harriet
rivera	rivera
fitzgerald	fitzgerald
ш	ш
caps	caps
dante	dante
myers	myers
knot	knot
mariano	mariano
danish	danish
jna	jna
bermuda	bermuda
idaho	idaho
rot	rot
sailor	sailor
howe	howe
associations	associations
relational	relational
joey	joey
waking	waking
reset	reset
refugee	refugee
zambia	zambia
beijing	beijing
barset	barset
finn	finn
directed	directed
cousin	cousin
spoken	spoken
surf	surf
needle	needle
ics	ics
afrique	afrique
beatrice	beatrice
kyle	kyle
ranking	ranking
grammy	grammy
rpc	rpc
persistence	persistence
alonso	alonso
inventory	inventory
shelter	shelter
essence	essence
nossa	nossa
gtr	gtr
stereo	stereo
sup	sup
benito	benito
alpine	alpine
buffer	buffer
chamberlain	chamberlain
wheeler	wheeler
hotcat	hotcat
continent	continent
nie	nie
gev	gev
monkeys	monkeys
agony	agony
zoology	zoology
maestro	maestro
rating	rating
xaml	xaml
sinensis	sinensis
bataille	bataille
introduced	introduced
barrett	barrett
gd	gd
eng	eng
marshal	marshal
basement	basement
boost	boost
magdalena	magdalena
highlighted	highlighted
bits	bits
marguerite	marguerite
macintosh	macintosh
fleming	fleming
loaded	loaded
boolean	boolean
cynthia	cynthia
servant	servant
juice	juice
heather	heather
container	container
massimo	massimo
tee	tee
dependency	dependency
spectacular	spectacular
fans	fans
tourist	tourist
biz	biz
norbert	norbert
fuscus	fuscus
northwestern	northwestern
gaston	gaston
jens	jens
polo	polo
ante	ante
occupational	occupational
sink	sink
powerful	powerful
login	login
arturo	arturo
removal	removal
sensitive	sensitive
jury	jury
roche	roche
reborn	reborn
bare	bare
andersen	andersen
mori	mori
eia	eia
uma	uma
ova	ova
bun	bun
honduras	honduras
gig	gig
imperator	imperator
closet	closet
byron	byron
edo	edo
artistic	artistic
championships	championships
coleman	coleman
comp	comp
republik	republik
harder	harder
wt	wt
battleship	battleship
vega	vega
pier	pier
connell	connell
rupert	rupert
vlc	vlc
ddt	ddt
kathy	kathy
velocity	velocity
fdr	fdr
neuroscience	neuroscience
significant	significant
jc	jc
duchess	duchess
systematic	systematic
neptune	neptune
bombs	bombs
phenomena	phenomena
cfo	cfo
fac	fac
hilton	hilton
за	за
yard	yard
troy	troy
primera	primera
fiba	fiba
spp	spp
shy	shy
zagreb	zagreb
drift	drift
strain	strain
constantine	constantine
dimensional	dimensional
appeal	appeal
hamlet	hamlet
armata	armata
springfield	springfield
enjoy	enjoy
jus	jus
republika	republika
protect	protect
cdna	cdna
diving	diving
variables	variables
analytical	analytical
pinto	pinto
hesse	hesse
düsseldorf	düsseldorf
plasma	plasma
inheritance	inheritance
territorial	territorial
córdoba	córdoba
repository	repository
submit	submit
debt	debt
altitude	altitude
stages	stages
specified	specified
ronnie	ronnie
dap	dap
played	played
interlude	interlude
ffd	ffd
jessie	jessie
semantic	semantic
fpga	fpga
reinhold	reinhold
niels	niels
encode	encode
oliveira	oliveira
buttons	buttons
leer	leer
temporary	temporary
finally	finally
equivalent	equivalent
genes	genes
vga	vga
circular	circular
fucking	fucking
chandler	chandler
funky	funky
vittorio	vittorio
bind	bind
benson	benson
fuzzy	fuzzy
styles	styles
generations	generations
satisfaction	satisfaction
arranged	arranged
hermes	hermes
zimmer	zimmer
bordeaux	bordeaux
shannon	shannon
š	š
zz	zz
prints	prints
wonders	wonders
sympathy	sympathy
coach	coach
mali	mali
rats	rats
turned	turned
pisa	pisa
tooth	tooth
quinn	quinn
skills	skills
clerk	clerk
brought	brought
rus	rus
władysław	władysław
loco	loco
cbu	cbu
lund	lund
gorge	gorge
items	items
jdam	jdam
nordic	nordic
ore	ore
zhang	zhang
marianne	marianne
aac	aac
coal	coal
sturm	sturm
elmer	elmer
apologies	apologies
gland	gland
habitat	habitat
anguilla	anguilla
runs	runs
telescope	telescope
specification	specification
cine	cine
judgment	judgment
nom	nom
cls	cls
infrared	infrared
warwick	warwick
margarita	margarita
lowell	lowell
singh	singh
duet	duet
województwo	województwo
cavalry	cavalry
criterion	criterion
founder	founder
ilo	ilo
paix	paix
cactus	cactus
wendy	wendy
emilia	emilia
sdk	sdk
rockets	rockets
wrc	wrc
gee	gee
martyrs	martyrs
pray	pray
eritrea	eritrea
smells	smells
bce	bce
delight	delight
beagle	beagle
caltech	caltech
treat	treat
gn	gn
iib	iib
ascension	ascension
witches	witches
recreation	recreation
hastings	hastings
seth	seth
dreamer	dreamer
pimp	pimp
cinerea	cinerea
brad	brad
lagenorhynchus	lagenorhynchus
ausf	ausf
athletics	athletics
teeth	teeth
estadio	estadio
evelyn	evelyn
reyes	reyes
worm	worm
brew	brew
promotion	promotion
karma	karma
iz	iz
esl	esl
flaming	flaming
galapagos	galapagos
bullets	bullets
sheridan	sheridan
nearly	nearly
kwk	kwk
mel	mel
macropus	macropus
facilities	facilities
collège	collège
mfc	mfc
fragments	fragments
toll	toll
developer	developer
croce	croce
harm	harm
humboldt	humboldt
rdf	rdf
garry	garry
giulio	giulio
jeans	jeans
compression	compression
fee	fee
riddle	riddle
pcp	pcp
mvc	mvc
mazda	mazda
vinci	vinci
sami	sami
debug	debug
shopping	shopping
cio	cio
starring	starring
galicia	galicia
uhf	uhf
plymouth	plymouth
gymnastics	gymnastics
manifesto	manifesto
ppt	ppt
_adidaswhite	_adidaswhite
venture	venture
shrine	shrine
indicator	indicator
medial	medial
bab	bab
interference	interference
alouatta	alouatta
readers	readers
predator	predator
hague	hague
avoid	avoid
bello	bello
tobias	tobias
binary	binary
johanna	johanna
overflow	overflow
martini	martini
claudio	claudio
cie	cie
satellites	satellites
jade	jade
philippine	philippine
ky	ky
missions	missions
dre	dre
accepted	accepted
hardcore	hardcore
ruiz	ruiz
worms	worms
helicopter	helicopter
lollipop	lollipop
modified	modified
chairman	chairman
wwdc	wwdc
fide	fide
ola	ola
capsule	capsule
butter	butter
ignored	ignored
sao	sao
toc	toc
embedded	embedded
shtml	shtml
founding	founding
password	password
ties	ties
marian	marian
realism	realism
ado	ado
sprint	sprint
braunschweig	braunschweig
wearing	wearing
mehmet	mehmet
antonia	antonia
dances	dances
strand	strand
libera	libera
clip	clip
params	params
oldest	oldest
uta	uta
valencia	valencia
venue	venue
yoo	yoo
acp	acp
coda	coda
narrow	narrow
faq	faq
prisoners	prisoners
д	д
libya	libya
f_k	f_k
vila	vila
hound	hound
mounted	mounted
marines	marines
hx	hx
castillo	castillo
sera	sera
sovereign	sovereign
athletic	athletic
voc	voc
barrow	barrow
cfc	cfc
automated	automated
earlier	earlier
invalid	invalid
surveillance	surveillance
_stripes_white	_stripes_white
bert	bert
regio	regio
forster	forster
thus	thus
versailles	versailles
eighth	eighth
jesús	jesús
emerson	emerson
mcdonald	mcdonald
fossil	fossil
buzz	buzz
hiroshima	hiroshima
iga	iga
explanation	explanation
operational	operational
cosmos	cosmos
gare	gare
zh	zh
carson	carson
logos	logos
household	household
investigations	investigations
casting	casting
btu	btu
fils	fils
vital	vital
lime	lime
centers	centers
baldwin	baldwin
kohn	kohn
budget	budget
montage	montage
cno	cno
ue	ue
scala	scala
simons	simons
usher	usher
powered	powered
excerpt	excerpt
toby	toby
jewel	jewel
characteristics	characteristics
bwv	bwv
agp	agp
judgement	judgement
hm	hm
cheek	cheek
griseus	griseus
eddy	eddy
eros	eros
prosper	prosper
tile	tile
tanzania	tanzania
couple	couple
principe	principe
jit	jit
marked	marked
sopa	sopa
rolls	rolls
displayed	displayed
bop	bop
bohemia	bohemia
tdi	tdi
attached	attached
meier	meier
lk	lk
throughout	throughout
footballdatabase	footballdatabase
vitae	vitae
glasgow	glasgow
ouest	ouest
proposed	proposed
brooke	brooke
routing	routing
dish	dish
inspired	inspired
polynesia	polynesia
locus	locus
designs	designs
starship	starship
apply	apply
nielsen	nielsen
cannes	cannes
fiat	fiat
descriptions	descriptions
robots	robots
aau	aau
nw	nw
eyewitness	eyewitness
confederate	confederate
technische	technische
buckley	buckley
basil	basil
ochotona	ochotona
gage	gage
polydor	polydor
martes	martes
passing	passing
allocation	allocation
mud	mud
crack	crack
concordia	concordia
contain	contain
zr	zr
periodical	periodical
kenny	kenny
woody	woody
concern	concern
ofi	ofi
józef	józef
fathers	fathers
castel	castel
planned	planned
botany	botany
protest	protest
byzantium	byzantium
oi	oi
bunker	bunker
cuckoo	cuckoo
bender	bender
neal	neal
ux	ux
rochester	rochester
nürnberg	nürnberg
isaiah	isaiah
welsh	welsh
races	races
е	е
hydra	hydra
ack	ack
pap	pap
≥	≥
gentle	gentle
governance	governance
nara	nara
advertising	advertising
guidelines	guidelines
foto	foto
except	except
б	б
defenders	defenders
retreat	retreat
chop	chop
orf	orf
yr	yr
nan	nan
aquatic	aquatic
seminar	seminar
noël	noël
ə	ə
enabled	enabled
omega	omega
ox	ox
ñ	ñ
isolation	isolation
licensed	licensed
ports	ports
renal	renal
crossover	crossover
bufo	bufo
hommes	hommes
xen	xen
stalingrad	stalingrad
mechanisms	mechanisms
checked	checked
elevator	elevator
calcium	calcium
mara	mara
alias	alias
deo	deo
raining	raining
rhine	rhine
brent	brent
trt	trt
vanessa	vanessa
blocks	blocks
delicious	delicious
priority	priority
eth	eth
rendezvous	rendezvous
simulator	simulator
_t	_t
abe	abe
hikaru	hikaru
senatus	senatus
repeat	repeat
amo	amo
wah	wah
prinz	prinz
gu	gu
genre	genre
boi	boi
collier	collier
notices	notices
laurel	laurel
wes	wes
afp	afp
smiley	smiley
slayer	slayer
blessed	blessed
kemp	kemp
andante	andante
caused	caused
requests	requests
cane	cane
monica	monica
diplomatic	diplomatic
armoured	armoured
particular	particular
cielo	cielo
bicolor	bicolor
fina	fina
selector	selector
numb	numb
lemon	lemon
bolt	bolt
wh	wh
carpenter	carpenter
rec	rec
soundcloud	soundcloud
cutting	cutting
ignorance	ignorance
soda	soda
nai	nai
booth	booth
cwc	cwc
polski	polski
jin	jin
matteo	matteo
pluto	pluto
notation	notation
biographies	biographies
accident	accident
henrik	henrik
tai	tai
mystic	mystic
starlight	starlight
rainer	rainer
ig	ig
destroyed	destroyed
exclusion	exclusion
matthews	matthews
slot	slot
valentin	valentin
tips	tips
endurance	endurance
jumping	jumping
brace	brace
yg	yg
cola	cola
cappella	cappella
switching	switching
quercus	quercus
extinct	extinct
fanny	fanny
voyager	voyager
wtf	wtf
cfr	cfr
pilgrim	pilgrim
pathway	pathway
holstein	holstein
lgbt	lgbt
overdrive	overdrive
extensive	extensive
gpp	gpp
unión	unión
dynamite	dynamite
nicholson	nicholson
goin	goin
macaca	macaca
sustainable	sustainable
barber	barber
outlaw	outlaw
reduction	reduction
bucket	bucket
lana	lana
headed	headed
improved	improved
trigger	trigger
clive	clive
exact	exact
speakers	speakers
herpestes	herpestes
boxer	boxer
rpf	rpf
fry	fry
settings	settings
init	init
beaver	beaver
ejb	ejb
greco	greco
ceo	ceo
younger	younger
sncf	sncf
rts	rts
indo	indo
holds	holds
mach	mach
burst	burst
pamela	pamela
desde	desde
successful	successful
pow	pow
sparks	sparks
pix	pix
mania	mania
simulation	simulation
grip	grip
waffen	waffen
delaware	delaware
molto	molto
dino	dino
halloween	halloween
datavalue	datavalue
journalism	journalism
ferrari	ferrari
pegi	pegi
entire	entire
valenti	valenti
sadness	sadness
hyperion	hyperion
l_n	l_n
wooden	wooden
flynn	flynn
regulus	regulus
handle	handle
naxos	naxos
bangladesh	bangladesh
vg	vg
attributes	attributes
jahr	jahr
someday	someday
baxter	baxter
marginal	marginal
manner	manner
libertad	libertad
armour	armour
odessa	odessa
facade	facade
cri	cri
ν	ν
liar	liar
palau	palau
adele	adele
cpl	cpl
ly	ly
dtm	dtm
brenda	brenda
cobol	cobol
occupied	occupied
aut	aut
concentration	concentration
pasha	pasha
pipes	pipes
lorenz	lorenz
sativa	sativa
unfinished	unfinished
dorsalis	dorsalis
scores	scores
tug	tug
stanisław	stanisław
bowman	bowman
alcohol	alcohol
ginger	ginger
olivia	olivia
cycles	cycles
atkinson	atkinson
supporting	supporting
brt	brt
snap	snap
starts	starts
shattered	shattered
tilia	tilia
xperia	xperia
sigma	sigma
xfce	xfce
ont	ont
ast	ast
sancti	sancti
díaz	díaz
ψ	ψ
higgins	higgins
daydream	daydream
motivation	motivation
wiz	wiz
guidance	guidance
tw	tw
pizza	pizza
botanical	botanical
sal	sal
hector	hector
eruption	eruption
dept	dept
diver	diver
advice	advice
photoshop	photoshop
jensen	jensen
squid	squid
flyer	flyer
swap	swap
reported	reported
kin	kin
tigers	tigers
sy	sy
ez	ez
ministers	ministers
familia	familia
returned	returned
hierarchy	hierarchy
clair	clair
bnp	bnp
tbilisi	tbilisi
mariana	mariana
ahmad	ahmad
posted	posted
visitor	visitor
curiosity	curiosity
ymca	ymca
transcription	transcription
rousseau	rousseau
announced	announced
mussolini	mussolini
mice	mice
mitte	mitte
atoll	atoll
breeding	breeding
modules	modules
stops	stops
barton	barton
norad	norad
icmp	icmp
ortiz	ortiz
layout	layout
morales	morales
spectroscopy	spectroscopy
jms	jms
gould	gould
babe	babe
kirk	kirk
arrest	arrest
everytime	everytime
authentication	authentication
rattus	rattus
boyz	boyz
shah	shah
valerie	valerie
saying	saying
bounty	bounty
lattice	lattice
coastal	coastal
climbing	climbing
numerical	numerical
openbsd	openbsd
mesoplodon	mesoplodon
ode	ode
harding	harding
browne	browne
jamaica	jamaica
expect	expect
perez	perez
conan	conan
kirby	kirby
cecilia	cecilia
dwarf	dwarf
empirical	empirical
azerbaijan	azerbaijan
ramsey	ramsey
beg	beg
conductor	conductor
curve	curve
pon	pon
cylinder	cylinder
nils	nils
nichols	nichols
thread	thread
scratch	scratch
oath	oath
virtue	virtue
shelley	shelley
checking	checking
lydia	lydia
mendoza	mendoza
dope	dope
trident	trident
dawson	dawson
methyl	methyl
yoga	yoga
lausanne	lausanne
ocinsoutput	ocinsoutput
germain	germain
lothar	lothar
hana	hana
madagascariensis	madagascariensis
aquarium	aquarium
discuss	discuss
improve	improve
antique	antique
guru	guru
stephan	stephan
yvonne	yvonne
renewal	renewal
mts	mts
asteroid	asteroid
fax	fax
fuse	fuse
laboratories	laboratories
ooh	ooh
osce	osce
lx	lx
representatives	representatives
everyman	everyman
ivf	ivf
geometric	geometric
jcb	jcb
channels	channels
eg	eg
snp	snp
trumpet	trumpet
gregorio	gregorio
lara	lara
assume	assume
oe	oe
bloomberg	bloomberg
components	components
hendrik	hendrik
rhode	rhode
lindsay	lindsay
alec	alec
kann	kann
gsg	gsg
caro	caro
discrimination	discrimination
ifc	ifc
feather	feather
followed	followed
ripper	ripper
utrecht	utrecht
parco	parco
heer	heer
nap	nap
controls	controls
wcf	wcf
martins	martins
toulouse	toulouse
presidents	presidents
updates	updates
slovakia	slovakia
andorra	andorra
kosovo	kosovo
boats	boats
reg	reg
convergence	convergence
dai	dai
wmap	wmap
orden	orden
jasper	jasper
w_i	w_i
gigas	gigas
cabin	cabin
existing	existing
mohamed	mohamed
difficult	difficult
lack	lack
managing	managing
ike	ike
mess	mess
astronomical	astronomical
т	т
χ	χ
cyclic	cyclic
cord	cord
vincenzo	vincenzo
orbital	orbital
calle	calle
reuters	reuters
efficiency	efficiency
prs	prs
synopsis	synopsis
germans	germans
giles	giles
abd	abd
networking	networking
cao	cao
destroyer	destroyer
xr	xr
gibbs	gibbs
canberra	canberra
wolves	wolves
yy	yy
hellenic	hellenic
wallis	wallis
iraqi	iraqi
rainy	rainy
être	être
nac	nac
nadph	nadph
wipo	wipo
eminem	eminem
itt	itt
appeared	appeared
began	began
fully	fully
ici	ici
effort	effort
snail	snail
muller	muller
hq	hq
kissing	kissing
i_n	i_n
jagger	jagger
provides	provides
crh	crh
trespass	trespass
transcript	transcript
extract	extract
vos	vos
cy	cy
queue	queue
muzik	muzik
clube	clube
hassan	hassan
individuals	individuals
р	р
sae	sae
rapids	rapids
_k	_k
laurie	laurie
holes	holes
bbb	bbb
angus	angus
mro	mro
coco	coco
lucifer	lucifer
kgb	kgb
bash	bash
stirling	stirling
gecko	gecko
admin	admin
ciel	ciel
curious	curious
lgpl	lgpl
rays	rays
gv	gv
zim	zim
compass	compass
shin	shin
neither	neither
healthcare	healthcare
prevent	prevent
vms	vms
longitude	longitude
suspension	suspension
cooling	cooling
thistle	thistle
relating	relating
denial	denial
od	od
truck	truck
petty	petty
inspection	inspection
gaming	gaming
hymn	hymn
`	`
votes	votes
oxide	oxide
citations	citations
ferreira	ferreira
mus	mus
brassica	brassica
nafta	nafta
kingdoms	kingdoms
snk	snk
bist	bist
medina	medina
dixon	dixon
optimization	optimization
activex	activex
windsor	windsor
keyboards	keyboards
mirotic	mirotic
checkuser	checkuser
woo	woo
salle	salle
pierce	pierce
actions	actions
bombay	bombay
propithecus	propithecus
pls	pls
nicola	nicola
jaime	jaime
burden	burden
howstuffworks	howstuffworks
arithmetic	arithmetic
taurus	taurus
quattro	quattro
willard	willard
suns	suns
vermont	vermont
revenue	revenue
discrete	discrete
provence	provence
wma	wma
communism	communism
palma	palma
audi	audi
apc	apc
goals	goals
rodriguez	rodriguez
cmp	cmp
electricity	electricity
ecb	ecb
consensus	consensus
fuji	fuji
meg	meg
git	git
stm	stm
skip	skip
chartvis	chartvis
analog	analog
reproduction	reproduction
blueprint	blueprint
guillermo	guillermo
tattoo	tattoo
asus	asus
formosa	formosa
civilizations	civilizations
ctr	ctr
transistor	transistor
ry	ry
legislative	legislative
burma	burma
moody	moody
sip	sip
schedule	schedule
brook	brook
roundel	roundel
wax	wax
cj	cj
chico	chico
venom	venom
coma	coma
neill	neill
conservatory	conservatory
dayz	dayz
pixel	pixel
staten	staten
reporting	reporting
validation	validation
yang	yang
tracker	tracker
invitation	invitation
biochemistry	biochemistry
remixed	remixed
rodrigo	rodrigo
ric	ric
scots	scots
grus	grus
stephens	stephens
appears	appears
numa	numa
newport	newport
dominus	dominus
iguana	iguana
rebels	rebels
jsf	jsf
scholarly	scholarly
anhalt	anhalt
interested	interested
lepilemur	lepilemur
dbe	dbe
nut	nut
vitamin	vitamin
tong	tong
faster	faster
lena	lena
≠	≠
brandon	brandon
bills	bills
winchester	winchester
atlético	atlético
copies	copies
profiles	profiles
campeonato	campeonato
nude	nude
src	src
norris	norris
identified	identified
quincy	quincy
baseball	baseball
csa	csa
census	census
steyr	steyr
alberta	alberta
sutherland	sutherland
derived	derived
calcio	calcio
eos	eos
esperanto	esperanto
riverside	riverside
receive	receive
nasdaq	nasdaq
mint	mint
labyrinth	labyrinth
ninth	ninth
nate	nate
sdtv	sdtv
concat	concat
squirrel	squirrel
pframe	pframe
ø	ø
sunt	sunt
musa	musa
candidates	candidates
bonaparte	bonaparte
audrey	audrey
bgm	bgm
vogel	vogel
longest	longest
sna	sna
gain	gain
dragonfly	dragonfly
ccc	ccc
patton	patton
enzyme	enzyme
konami	konami
shirt	shirt
merlin	merlin
emacs	emacs
collector	collector
oaks	oaks
amen	amen
burial	burial
sata	sata
cricket	cricket
seoul	seoul
clap	clap
meridian	meridian
icons	icons
ritchie	ritchie
percent	percent
mandarin	mandarin
quark	quark
deployment	deployment
stephanie	stephanie
robson	robson
stg	stg
modena	modena
municipality	municipality
zi	zi
xj	xj
irwin	irwin
rwanda	rwanda
csc	csc
fleur	fleur
sudden	sudden
trent	trent
tate	tate
cmd	cmd
_blackshoulders	_blackshoulders
helping	helping
montenegro	montenegro
brilliant	brilliant
rum	rum
sch	sch
cfm	cfm
algeria	algeria
caco	caco
shen	shen
puppy	puppy
fiesta	fiesta
gundam	gundam
sq	sq
dupont	dupont
featured	featured
sheikh	sheikh
uzi	uzi
protocols	protocols
shining	shining
overture	overture
warnings	warnings
wpa	wpa
gradient	gradient
metabolism	metabolism
æ	æ
hoboken	hoboken
unc	unc
cvn	cvn
minus	minus
commit	commit
ibrahim	ibrahim
atkins	atkins
amherst	amherst
slash	slash
founded	founded
yb	yb
cto	cto
colon	colon
speedy	speedy
iglesia	iglesia
joanna	joanna
kyoto	kyoto
saddle	saddle
sherwood	sherwood
juli	juli
tra	tra
kirche	kirche
ver	ver
huge	huge
confederation	confederation
tracking	tracking
hooker	hooker
danielle	danielle
insane	insane
nico	nico
ber	ber
fog	fog
combination	combination
automobile	automobile
leah	leah
costs	costs
amount	amount
sens	sens
launched	launched
dillon	dillon
²	²
brazilian	brazilian
hoover	hoover
completely	completely
tos	tos
older	older
fold	fold
hawkins	hawkins
mainsnak	mainsnak
tabs	tabs
loan	loan
guid	guid
smoking	smoking
explosive	explosive
nottingham	nottingham
unicorn	unicorn
cbt	cbt
wee	wee
inspiration	inspiration
gx	gx
distinct	distinct
bastard	bastard
brush	brush
hung	hung
tamias	tamias
spiders	spiders
carlton	carlton
attribute	attribute
slate	slate
almeida	almeida
streaming	streaming
unofficial	unofficial
htv	htv
dlc	dlc
alicia	alicia
accept	accept
freeze	freeze
stokes	stokes
richter	richter
spotted	spotted
vascular	vascular
serenade	serenade
nevis	nevis
uno	uno
mongol	mongol
seo	seo
ы	ы
mol	mol
peterson	peterson
logistics	logistics
colonies	colonies
potassium	potassium
ems	ems
epoch	epoch
ما	ما
annette	annette
institutes	institutes
mule	mule
communis	communis
lightblue	lightblue
francesca	francesca
porsche	porsche
lenin	lenin
grimm	grimm
finder	finder
ej	ej
indoor	indoor
watchlist	watchlist
bismarck	bismarck
sensor	sensor
‘	‘
missionary	missionary
lam	lam
rz	rz
weiß	weiß
petrus	petrus
gustavo	gustavo
kepler	kepler
nepal	nepal
chord	chord
enforcement	enforcement
slaves	slaves
everett	everett
clocks	clocks
pegasus	pegasus
lawson	lawson
gy	gy
sung	sung
crab	crab
schema	schema
locked	locked
statements	statements
dw	dw
challenger	challenger
apparatus	apparatus
preference	preference
flux	flux
decimal	decimal
ericsson	ericsson
impression	impression
congressional	congressional
iptv	iptv
authorlink	authorlink
aren	aren
lune	lune
stadion	stadion
latitude	latitude
nikki	nikki
sickness	sickness
swallow	swallow
tem	tem
hancock	hancock
clothes	clothes
abdul	abdul
denise	denise
chips	chips
planck	planck
abyss	abyss
proposals	proposals
momentum	momentum
région	région
highlights	highlights
caucasus	caucasus
disabled	disabled
officinalis	officinalis
namibia	namibia
wba	wba
ffdd	ffdd
cinderella	cinderella
dominic	dominic
amr	amr
representative	representative
luís	luís
butterflies	butterflies
sia	sia
nixon	nixon
mwc	mwc
cnc	cnc
aberdeen	aberdeen
argus	argus
requires	requires
travis	travis
enable	enable
compendium	compendium
gmp	gmp
idc	idc
accent	accent
evergreen	evergreen
_r	_r
raj	raj
propulsion	propulsion
generic	generic
bonds	bonds
rosario	rosario
utm	utm
jaguar	jaguar
whisper	whisper
established	established
coca	coca
unep	unep
chin	chin
ict	ict
curriculum	curriculum
highly	highly
decay	decay
norfolk	norfolk
ours	ours
shawn	shawn
sherry	sherry
g_i	g_i
urbana	urbana
luv	luv
μm	μm
bahrain	bahrain
≤	≤
mii	mii
sham	sham
freestyle	freestyle
ruin	ruin
randolph	randolph
formal	formal
faust	faust
scripting	scripting
xu	xu
positions	positions
sable	sable
ute	ute
ger	ger
armando	armando
exhibit	exhibit
mpaa	mpaa
grupo	grupo
sod	sod
honolulu	honolulu
_x	_x
hustle	hustle
corruption	corruption
fisheries	fisheries
heap	heap
haley	haley
trujillo	trujillo
pivot	pivot
remain	remain
marne	marne
taiwan	taiwan
dcs	dcs
watt	watt
scsi	scsi
cics	cics
helper	helper
jennings	jennings
larsen	larsen
carrie	carrie
supernatural	supernatural
moor	moor
dive	dive
thierry	thierry
regensburg	regensburg
montréal	montréal
jive	jive
improving	improving
acs	acs
substances	substances
oceanic	oceanic
allows	allows
suzuki	suzuki
terrace	terrace
quantitative	quantitative
piotr	piotr
mute	mute
std	std
criteria	criteria
heavens	heavens
separated	separated
uzbekistan	uzbekistan
bcs	bcs
dispute	dispute
allium	allium
eon	eon
contributors	contributors
neville	neville
slideshow	slideshow
adb	adb
eileen	eileen
determination	determination
surveys	surveys
hno	hno
marcos	marcos
pius	pius
fishing	fishing
nakamura	nakamura
garfield	garfield
blitz	blitz
bibcode	bibcode
abdullah	abdullah
tunes	tunes
eudyptes	eudyptes
monty	monty
belly	belly
claimed	claimed
eurasian	eurasian
bj	bj
humphrey	humphrey
sven	sven
kern	kern
asc	asc
mata	mata
pip	pip
nautilus	nautilus
brett	brett
ssn	ssn
factbook	factbook
worship	worship
relay	relay
pda	pda
forge	forge
asic	asic
leiocephalus	leiocephalus
lowe	lowe
boyfriend	boyfriend
heal	heal
damon	damon
affinis	affinis
optional	optional
entries	entries
zeta	zeta
kreis	kreis
hannover	hannover
ecclesia	ecclesia
clare	clare
increase	increase
explosion	explosion
hydrogen	hydrogen
kat	kat
curry	curry
bazaar	bazaar
rag	rag
travail	travail
crowned	crowned
directly	directly
eis	eis
ritz	ritz
fredrik	fredrik
baltic	baltic
etat	etat
specimen	specimen
welch	welch
disambig	disambig
lap	lap
owner	owner
coordination	coordination
outdoor	outdoor
ursula	ursula
tick	tick
nora	nora
gym	gym
conception	conception
waterfall	waterfall
juniperus	juniperus
beliefs	beliefs
pistol	pistol
localsettings	localsettings
termination	termination
zinc	zinc
⅓	⅓
toon	toon
kendall	kendall
¼	¼
mustafa	mustafa
introductory	introductory
brendan	brendan
ratp	ratp
groovy	groovy
follows	follows
todos	todos
­	­
allies	allies
nox	nox
crs	crs
nui	nui
maze	maze
addiction	addiction
heartbreaker	heartbreaker
thorn	thorn
technological	technological
flanders	flanders
msm	msm
ria	ria
xz	xz
jas	jas
nasty	nasty
exists	exists
botswana	botswana
awk	awk
taipei	taipei
donovan	donovan
gg	gg
favourite	favourite
cooke	cooke
kam	kam
astro	astro
sram	sram
hmg	hmg
winged	winged
reina	reina
normandy	normandy
asset	asset
avery	avery
instance	instance
servers	servers
bgb	bgb
indie	indie
marta	marta
wesleyan	wesleyan
zen	zen
tara	tara
brady	brady
inversion	inversion
mano	mano
ismail	ismail
fedora	fedora
latino	latino
erika	erika
brandt	brandt
lccn	lccn
unam	unam
coke	coke
geoff	geoff
motors	motors
_blackborder	_blackborder
víctor	víctor
yamaha	yamaha
sax	sax
abandoned	abandoned
tj	tj
frs	frs
gall	gall
siren	siren
mist	mist
analytic	analytic
pga	pga
rolf	rolf
tram	tram
nemesis	nemesis
ping	ping
omg	omg
atmosphere	atmosphere
chad	chad
patrie	patrie
ligo	ligo
yx	yx
jobs	jobs
announcement	announcement
shu	shu
veritas	veritas
musician	musician
silicon	silicon
nostalgia	nostalgia
proto	proto
matilda	matilda
cara	cara
kazakhstan	kazakhstan
rana	rana
sparrow	sparrow
álvaro	álvaro
b_k	b_k
terminology	terminology
kuwait	kuwait
balkans	balkans
feelings	feelings
yz	yz
hindu	hindu
antoinette	antoinette
uz	uz
owens	owens
ads	ads
mustard	mustard
periods	periods
pj	pj
joker	joker
nail	nail
presto	presto
première	première
ug	ug
melvin	melvin
unification	unification
depot	depot
martyr	martyr
electoral	electoral
mccartney	mccartney
stolen	stolen
oval	oval
fairchild	fairchild
torn	torn
_redborder	_redborder
loading	loading
gina	gina
experts	experts
alexa	alexa
freely	freely
lester	lester
blink	blink
bud	bud
souza	souza
ottawa	ottawa
mixing	mixing
viper	viper
designed	designed
hex	hex
_thinblacksides	_thinblacksides
addclass	addclass
aip	aip
ogle	ogle
isl	isl
completed	completed
indies	indies
cmyk	cmyk
alignment	alignment
employee	employee
tailed	tailed
oldid	oldid
reload	reload
whip	whip
isdn	isdn
sparc	sparc
stuck	stuck
columba	columba
sophia	sophia
awareness	awareness
okay	okay
dubai	dubai
perkins	perkins
mta	mta
pde	pde
badger	badger
halt	halt
portsmouth	portsmouth
receiver	receiver
thirteen	thirteen
reasonable	reasonable
engl	engl
florian	florian
approximation	approximation
apus	apus
cpa	cpa
dq	dq
tristan	tristan
opposition	opposition
prometheus	prometheus
nebula	nebula
franck	franck
runtime	runtime
insomnia	insomnia
romero	romero
yak	yak
cart	cart
perhaps	perhaps
xxxholic	xxxholic
mnet	mnet
identify	identify
btl	btl
dwight	dwight
accessible	accessible
pointer	pointer
precious	precious
qi	qi
caldwell	caldwell
geiger	geiger
essen	essen
pandora	pandora
grandis	grandis
belfast	belfast
produce	produce
congregatio	congregatio
cruiser	cruiser
epp	epp
formats	formats
dit	dit
vim	vim
collage	collage
fruits	fruits
syfy	syfy
viridis	viridis
paparazzi	paparazzi
mistake	mistake
encoding	encoding
lying	lying
hy	hy
albuquerque	albuquerque
itc	itc
heading	heading
patterson	patterson
mei	mei
spec	spec
wolff	wolff
playboy	playboy
formatting	formatting
journalist	journalist
github	github
minimal	minimal
indianapolis	indianapolis
demonstration	demonstration
macau	macau
gregg	gregg
dpkg	dpkg
coupe	coupe
reactor	reactor
bayer	bayer
d_n	d_n
amoled	amoled
tracing	tracing
yoshi	yoshi
rsi	rsi
japonicus	japonicus
stacked	stacked
doris	doris
evo	evo
duplex	duplex
hutton	hutton
gala	gala
banda	banda
mobility	mobility
trim	trim
arrows	arrows
albus	albus
xxiv	xxiv
fokker	fokker
spelling	spelling
grown	grown
facelift	facelift
fad	fad
crimea	crimea
mais	mais
dose	dose
distorted	distorted
restriction	restriction
meters	meters
doomsday	doomsday
narcissus	narcissus
pathfinder	pathfinder
aristotle	aristotle
monarch	monarch
vfb	vfb
personnel	personnel
nicaragua	nicaragua
_shoulder_stripes_white_stripes	_shoulder_stripes_white_stripes
uu	uu
persona	persona
jk	jk
elton	elton
vinyl	vinyl
swamp	swamp
telnet	telnet
sells	sells
handler	handler
abigail	abigail
pca	pca
regression	regression
canine	canine
sulcus	sulcus
antigen	antigen
hess	hess
dots	dots
bcg	bcg
inhibitor	inhibitor
fiji	fiji
cpt	cpt
banque	banque
doug	doug
tobacco	tobacco
tags	tags
lyric	lyric
stellar	stellar
rodgers	rodgers
siam	siam
persecution	persecution
mermaid	mermaid
flows	flows
reception	reception
chu	chu
citationclass	citationclass
celebrate	celebrate
airbus	airbus
mmorpg	mmorpg
boyle	boyle
buster	buster
emirates	emirates
bergman	bergman
vive	vive
toad	toad
bowling	bowling
dolce	dolce
ing	ing
poco	poco
wishes	wishes
airplay	airplay
marcia	marcia
herb	herb
brabant	brabant
reformation	reformation
erin	erin
packed	packed
zoological	zoological
excellent	excellent
usl	usl
anchor_year	anchor_year
zenith	zenith
_u	_u
robbie	robbie
orchard	orchard
netbsd	netbsd
typhoon	typhoon
dolby	dolby
cosmo	cosmo
upi	upi
trunk	trunk
dello	dello
feeding	feeding
sourceforge	sourceforge
robotics	robotics
faithful	faithful
pagan	pagan
tok	tok
ruff	ruff
goods	goods
artur	artur
dn	dn
renault	renault
dangerously	dangerously
gong	gong
absent	absent
bryant	bryant
milne	milne
duchy	duchy
preparation	preparation
з	з
gurls	gurls
mentioned	mentioned
vw	vw
janusz	janusz
zachary	zachary
schultz	schultz
previous	previous
ignore	ignore
cardiff	cardiff
reserved	reserved
edx	edx
felice	felice
grub	grub
hosts	hosts
newcastle	newcastle
schön	schön
pagename	pagename
omnia	omnia
pokémon	pokémon
stp	stp
hardware	hardware
palermo	palermo
frankie	frankie
dod	dod
nathalie	nathalie
eda	eda
podcast	podcast
dartmouth	dartmouth
sheets	sheets
bdfutbol	bdfutbol
lavender	lavender
gpu	gpu
observed	observed
oem	oem
schott	schott
dvi	dvi
zodiac	zodiac
laude	laude
democrat	democrat
pater	pater
tribal	tribal
rugby	rugby
curves	curves
gian	gian
unsigned	unsigned
pygmaeus	pygmaeus
cnbc	cnbc
italic	italic
turing	turing
pastor	pastor
scattering	scattering
asked	asked
pira	pira
notebook	notebook
escudo	escudo
gauge	gauge
molina	molina
ceiling	ceiling
sox	sox
belize	belize
prerogative	prerogative
queensland	queensland
nascar	nascar
peach	peach
bernd	bernd
katie	katie
liu	liu
preserve	preserve
fes	fes
nomenclature	nomenclature
burundi	burundi
gin	gin
maynard	maynard
contrast	contrast
josephine	josephine
freddy	freddy
simplex	simplex
grants	grants
papaver	papaver
northrop	northrop
icp	icp
gum	gum
roach	roach
rft	rft
dalton	dalton
serbian	serbian
stanton	stanton
tmp	tmp
sulfate	sulfate
pubescens	pubescens
victim	victim
offer	offer
coupling	coupling
hilbert	hilbert
uw	uw
cert	cert
whois	whois
malik	malik
ytv	ytv
thrust	thrust
umno	umno
victoire	victoire
tutorial	tutorial
kinds	kinds
altar	altar
jolly	jolly
chinatown	chinatown
stores	stores
stat	stat
continued	continued
beside	beside
reagan	reagan
riemann	riemann
skidmore	skidmore
hussein	hussein
subway	subway
nou	nou
manga	manga
honors	honors
rlc	rlc
osborne	osborne
npd	npd
potsdam	potsdam
antigua	antigua
signed	signed
beard	beard
gracilis	gracilis
aida	aida
blg	blg
remind	remind
ava	ava
ifa	ifa
clr	clr
clancy	clancy
meu	meu
rover	rover
davenport	davenport
ended	ended
molecules	molecules
cristina	cristina
pz	pz
sections	sections
iff	iff
quit	quit
eugenia	eugenia
lai	lai
soi	soi
everlasting	everlasting
consumption	consumption
savannah	savannah
olympus	olympus
gamer	gamer
lw	lw
didier	didier
eulemur	eulemur
boutique	boutique
mvs	mvs
kon	kon
csm	csm
unwin	unwin
pencil	pencil
habit	habit
melodies	melodies
quantity	quantity
compiler	compiler
microrna	microrna
hernández	hernández
scholastic	scholastic
terrestrial	terrestrial
fou	fou
fender	fender
butcher	butcher
dts	dts
moe	moe
sta	sta
ccl	ccl
emp	emp
dtd	dtd
brewster	brewster
fabric	fabric
neighbor	neighbor
isp	isp
complicated	complicated
iglesias	iglesias
ucl	ucl
colours	colours
rows	rows
manning	manning
unreleased	unreleased
picasso	picasso
gz	gz
reduced	reduced
stonewall	stonewall
touring	touring
wilder	wilder
pause	pause
dvr	dvr
tes	tes
mond	mond
managed	managed
starz	starz
peripheral	peripheral
officials	officials
hun	hun
tempest	tempest
elaphus	elaphus
vent	vent
pds	pds
corresponding	corresponding
richie	richie
batch	batch
weir	weir
tight	tight
somalia	somalia
chill	chill
bedford	bedford
hurd	hurd
apo	apo
countess	countess
singular	singular
tft	tft
huntington	huntington
_blueshoulders	_blueshoulders
junk	junk
sarajevo	sarajevo
hsdpa	hsdpa
yoko	yoko
modular	modular
boxes	boxes
cmmi	cmmi
generally	generally
captured	captured
shuffle	shuffle
andromeda	andromeda
electromagnetic	electromagnetic
tested	tested
walters	walters
liechtenstein	liechtenstein
pitchfork	pitchfork
commune	commune
vl	vl
naturally	naturally
asm	asm
efficient	efficient
lambda	lambda
constance	constance
calculator	calculator
oled	oled
new_args	new_args
futebol	futebol
samoa	samoa
hawks	hawks
gba	gba
teil	teil
addresses	addresses
chaser	chaser
sensory	sensory
grep	grep
moro	moro
iit	iit
reboot	reboot
melo	melo
faso	faso
arcadia	arcadia
sxsw	sxsw
emmy	emmy
vidal	vidal
bytes	bytes
releases	releases
easier	easier
natalia	natalia
ghana	ghana
holidays	holidays
lvmh	lvmh
masterpiece	masterpiece
responsible	responsible
ballistic	ballistic
cve	cve
gbs	gbs
ddc	ddc
snyder	snyder
lunch	lunch
covering	covering
tibet	tibet
_thinredsides	_thinredsides
uy	uy
gambia	gambia
latvia	latvia
_color_	_color_
ccm	ccm
decode	decode
bau	bau
unhcr	unhcr
kama	kama
z_i	z_i
parser	parser
kei	kei
micrixalus	micrixalus
listing	listing
oleg	oleg
campos	campos
cisco	cisco
rcs	rcs
ina	ina
zombie	zombie
esse	esse
cuda	cuda
fresco	fresco
tina	tina
sibirica	sibirica
cst	cst
zp	zp
processor	processor
nike	nike
tis	tis
compound	compound
commando	commando
createelement	createelement
guggenheim	guggenheim
vaccine	vaccine
rodrigues	rodrigues
thaad	thaad
hon	hon
brewer	brewer
sps	sps
guided	guided
zimbabwe	zimbabwe
byrne	byrne
clover	clover
zw	zw
sears	sears
mckay	mckay
ctc	ctc
winding	winding
opened	opened
jj	jj
barnett	barnett
jw	jw
voz	voz
manila	manila
passive	passive
electro	electro
ч	ч
servlet	servlet
motorola	motorola
departure	departure
gibb	gibb
daniels	daniels
locke	locke
galactic	galactic
sino	sino
notte	notte
ica	ica
bicycle	bicycle
dagger	dagger
ramírez	ramírez
vince	vince
aesa	aesa
jf	jf
puff	puff
lms	lms
tow	tow
aries	aries
mambo	mambo
wg	wg
publicationdate	publicationdate
mediation	mediation
cheng	cheng
hornet	hornet
measuring	measuring
kev	kev
oman	oman
mens	mens
ucs	ucs
knee	knee
augustine	augustine
restricted	restricted
wd	wd
defaults	defaults
carriers	carriers
ddg	ddg
temminckii	temminckii
melanie	melanie
trend	trend
ids	ids
يا	يا
mira	mira
wei	wei
seeking	seeking
insulin	insulin
glove	glove
parma	parma
elsa	elsa
ena	ena
tz	tz
vibe	vibe
dewey	dewey
borg	borg
_adidasonwhite	_adidasonwhite
silvestris	silvestris
javanicus	javanicus
obscurus	obscurus
isabelle	isabelle
horton	horton
despite	despite
vulnerable	vulnerable
steward	steward
alves	alves
polaris	polaris
mauritius	mauritius
qq	qq
spectral	spectral
cork	cork
kidd	kidd
megan	megan
toe	toe
cubic	cubic
bryce	bryce
estádio	estádio
procedures	procedures
busy	busy
leur	leur
paraguay	paraguay
pusillus	pusillus
designated	designated
wgs	wgs
designation	designation
breaker	breaker
dumb	dumb
burger	burger
hearing	hearing
boulogne	boulogne
barr	barr
fowler	fowler
svn	svn
xk	xk
ā	ā
infected	infected
poe	poe
silly	silly
extrasolar	extrasolar
subterranean	subterranean
jong	jong
acorn	acorn
msds	msds
champ	champ
replication	replication
hosted	hosted
tenerife	tenerife
navbox	navbox
fait	fait
newly	newly
trains	trains
история	история
avc	avc
icann	icann
gallagher	gallagher
bandai	bandai
wmv	wmv
marching	marching
kart	kart
ф	ф
й	й
camden	camden
intensity	intensity
spartak	spartak
cuban	cuban
psd	psd
namco	namco
midland	midland
whiskey	whiskey
fsv	fsv
liam	liam
bourbon	bourbon
_b	_b
striped	striped
‡	‡
primus	primus
adc	adc
cccc	cccc
ricky	ricky
darren	darren
toyota	toyota
grp	grp
dht	dht
ldh	ldh
irs	irs
traveler	traveler
россия	россия
sandbox	sandbox
empress	empress
replacement	replacement
lf	lf
specialist	specialist
olpc	olpc
vulcan	vulcan
whales	whales
a_j	a_j
bjp	bjp
ranks	ranks
vert	vert
cory	cory
pps	pps
rosso	rosso
peggy	peggy
prologue	prologue
tet	tet
cummings	cummings
nauru	nauru
meteor	meteor
upgrade	upgrade
marseille	marseille
concord	concord
novi	novi
yin	yin
ю	ю
kj	kj
aston	aston
oricon	oricon
ryder	ryder
ifk	ifk
meal	meal
euler	euler
fang	fang
deg	deg
dario	dario
matches	matches
luminous	luminous
bounce	bounce
microscope	microscope
snl	snl
dunn	dunn
cited	cited
mcgill	mcgill
cbr	cbr
judo	judo
gunnar	gunnar
ehf	ehf
succession	succession
sting	sting
celeste	celeste
lightweight	lightweight
federated	federated
easily	easily
sana	sana
tiffany	tiffany
func	func
tba	tba
typical	typical
meter	meter
eps	eps
reliance	reliance
voluntary	voluntary
undo	undo
starcraft	starcraft
athena	athena
iai	iai
elk	elk
bloc	bloc
undefined	undefined
expressions	expressions
gbps	gbps
scc	scc
ability	ability
kasumi	kasumi
surrounding	surrounding
shepard	shepard
lama	lama
distortion	distortion
lotte	lotte
jörg	jörg
sosa	sosa
ehre	ehre
luka	luka
buda	buda
customer	customer
cfl	cfl
supports	supports
laid	laid
arial	arial
parliamentary	parliamentary
augsburg	augsburg
gk	gk
fed	fed
dum	dum
mustang	mustang
considerations	considerations
kar	kar
togo	togo
yum	yum
larsson	larsson
deputy	deputy
cfb	cfb
shan	shan
tot	tot
caa	caa
nitro	nitro
influences	influences
extremely	extremely
ppc	ppc
ruben	ruben
franca	franca
hsp	hsp
kristian	kristian
wtc	wtc
mers	mers
ipx	ipx
represent	represent
deaf	deaf
newell	newell
cambodia	cambodia
airline	airline
livingston	livingston
sag	sag
triathlon	triathlon
senegal	senegal
gabriela	gabriela
repair	repair
francorum	francorum
issued	issued
marty	marty
confession	confession
ivoire	ivoire
detector	detector
debian	debian
minsk	minsk
nextstep	nextstep
kaj	kaj
harley	harley
eff	eff
fiona	fiona
arias	arias
focal	focal
luce	luce
paulus	paulus
jukebox	jukebox
f_t	f_t
verband	verband
cod	cod
smg	smg
cockpit	cockpit
µm	µm
mejor	mejor
sabre	sabre
awarded	awarded
bleach	bleach
kappa	kappa
lis	lis
loser	loser
gavin	gavin
override	override
reno	reno
cma	cma
arrangement	arrangement
moby	moby
orb	orb
definitely	definitely
dummy	dummy
spc	spc
coaster	coaster
ambystoma	ambystoma
recht	recht
eax	eax
contributor	contributor
dbs	dbs
cli	cli
wikiproject	wikiproject
mov	mov
nurse	nurse
bolivia	bolivia
bates	bates
possibility	possibility
carvalho	carvalho
boer	boer
karin	karin
usmc	usmc
barnard	barnard
tortoise	tortoise
∨	∨
perform	perform
sergei	sergei
correction	correction
msl	msl
showdown	showdown
acad	acad
blossom	blossom
hicks	hicks
clips	clips
duffy	duffy
reeves	reeves
grammophon	grammophon
charm	charm
groves	groves
shane	shane
revert	revert
gtb	gtb
runway	runway
sirius	sirius
koi	koi
rene	rene
kiev	kiev
covers	covers
mclean	mclean
semper	semper
sho	sho
thessaloniki	thessaloniki
tik	tik
gravitational	gravitational
blocked	blocked
tequila	tequila
fungi	fungi
snmp	snmp
mansfield	mansfield
shaun	shaun
fetch	fetch
z_n	z_n
purchase	purchase
cdi	cdi
lamborghini	lamborghini
ιωάννης	ιωάννης
alo	alo
msi	msi
rbi	rbi
budokan	budokan
scanning	scanning
felt	felt
reverend	reverend
polytechnic	polytechnic
